Rk,Player,Pos,Age,Tm,G,GS,MP,FG,FGA,FG%,3P,3PA,3P%,2P,2PA,2P%,eFG%,FT,FTA,FT%,ORB,DRB,TRB,AST,STL,BLK,TOV,PF,PTS
1,Quincy Acy\acyqu01,PF,22,TOR,29,0,342,42,75,.560,1,2,.500,41,73,.562,.567,31,38,.816,30,47,77,11,13,15,17,53,116
2,Jeff Adrien\adrieje01,PF,26,CHA,52,5,713,72,168,.429,0,2,.000,72,166,.434,.429,65,100,.650,68,128,196,36,18,27,32,80,209
3,Arron Afflalo\afflaar01,SF,27,ORL,64,64,2307,397,905,.439,72,240,.300,325,665,.489,.478,191,223,.857,29,210,239,206,40,11,138,137,1057
4,Josh Akognon\akognjo01,PG,26,DAL,3,0,9,2,4,.500,1,2,.500,1,2,.500,.625,0,0,,0,1,1,1,0,0,0,3,5
5,Cole Aldrich\aldrico01,C,24,TOT,45,0,388,44,80,.550,0,0,,44,80,.550,.550,12,20,.600,30,90,120,9,5,23,23,60,100
5,Cole Aldrich\aldrico01,C,24,HOU,30,0,213,23,43,.535,0,0,,23,43,.535,.535,4,9,.444,12,45,57,6,3,9,14,41,50
5,Cole Aldrich\aldrico01,C,24,SAC,15,0,175,21,37,.568,0,0,,21,37,.568,.568,8,11,.727,18,45,63,3,2,14,9,19,50
6,LaMarcus Aldridge\aldrila01,PF,27,POR,74,74,2790,638,1318,.484,2,14,.143,636,1304,.488,.485,282,348,.810,175,495,670,192,62,91,143,187,1560
7,Lavoy Allen\allenla01,C,23,PHI,79,37,1669,206,454,.454,0,1,.000,206,453,.455,.454,43,60,.717,159,236,395,73,24,55,55,180,455
8,Ray Allen*\allenra02,SG,37,MIA,79,0,2035,292,651,.449,139,332,.419,153,319,.480,.555,140,158,.886,40,177,217,135,67,15,103,129,863
9,Tony Allen\allento01,SG,31,MEM,79,79,2109,284,638,.445,3,24,.125,281,614,.458,.447,134,187,.717,121,242,363,98,119,44,94,211,705
10,Al-Farouq Aminu\aminual01,SF,22,NOH,76,71,2066,225,474,.475,4,19,.211,221,455,.486,.479,101,137,.737,139,446,585,103,92,51,116,153,555
11,Lou Amundson\amundlo01,PF,30,TOT,39,0,372,32,81,.395,0,0,,32,81,.395,.395,12,36,.333,48,58,106,11,16,12,19,53,76
11,Lou Amundson\amundlo01,PF,30,MIN,20,0,161,14,38,.368,0,0,,14,38,.368,.368,4,20,.200,23,24,47,3,7,6,11,26,32
11,Lou Amundson\amundlo01,PF,30,CHI,1,0,2,0,1,.000,0,0,,0,1,.000,.000,0,0,,1,0,1,0,0,0,0,0,0
11,Lou Amundson\amundlo01,PF,30,NOH,18,0,209,18,42,.429,0,0,,18,42,.429,.429,8,16,.500,24,34,58,8,9,6,8,27,44
12,Chris Andersen\anderch01,C,34,MIA,42,0,624,71,123,.577,2,3,.667,69,120,.575,.585,63,93,.677,57,115,172,17,16,44,24,89,207
13,Alan Anderson\anderal01,SF,30,TOR,65,2,1495,236,616,.383,95,285,.333,141,331,.426,.460,126,147,.857,34,114,148,103,48,7,80,131,693
14,James Anderson\anderja01,SG-SF,23,TOT,39,2,401,52,126,.413,21,60,.350,31,66,.470,.496,24,28,.857,18,54,72,42,15,5,25,25,149
14,James Anderson\anderja01,SF,23,SAS,10,0,94,11,25,.440,5,11,.455,6,14,.429,.540,7,9,.778,3,11,14,9,3,2,7,7,34
14,James Anderson\anderja01,SG,23,HOU,29,2,307,41,101,.406,16,49,.327,25,52,.481,.485,17,19,.895,15,43,58,33,12,3,18,18,115
15,Ryan Anderson\anderry01,PF,24,NOH,81,22,2503,472,1115,.423,213,557,.382,259,558,.464,.519,152,180,.844,191,328,519,97,42,31,97,179,1309
16,Carmelo Anthony\anthoca01,PF,28,NYK,67,67,2482,669,1489,.449,157,414,.379,512,1075,.476,.502,425,512,.830,134,326,460,171,52,32,175,205,1920
17,Joel Anthony\anthojo01,C,30,MIA,62,3,566,35,68,.515,0,0,,35,68,.515,.515,17,28,.607,45,70,115,13,13,42,22,49,87
18,Trevor Ariza\arizatr01,SF,27,WAS,56,15,1471,188,451,.417,76,209,.364,112,242,.463,.501,78,95,.821,44,222,266,113,72,20,84,72,530
19,Darrell Arthur\arthuda01,PF,24,MEM,59,3,970,162,359,.451,5,18,.278,157,341,.460,.458,33,46,.717,68,101,169,33,24,33,43,126,362
20,Omer Asik\asikom01,C,26,HOU,82,82,2464,332,614,.541,0,1,.000,332,613,.542,.541,168,299,.562,275,681,956,75,46,87,173,223,832
21,D.J. Augustin\augusdj01,PG,25,IND,76,5,1226,103,294,.350,67,190,.353,36,104,.346,.464,83,99,.838,20,71,91,170,34,3,68,64,356
22,Gustavo Ayon\ayongu01,C,27,TOT,55,3,734,92,167,.551,0,0,,92,167,.551,.551,20,50,.400,60,139,199,71,22,17,47,107,204
22,Gustavo Ayon\ayongu01,C,27,ORL,43,3,571,67,125,.536,0,0,,67,125,.536,.536,19,38,.500,40,100,140,59,13,13,38,83,153
22,Gustavo Ayon\ayongu01,C,27,MIL,12,0,163,25,42,.595,0,0,,25,42,.595,.595,1,12,.083,20,39,59,12,9,4,9,24,51
23,Jeff Ayres\pendeje02,PF,25,IND,37,0,369,61,126,.484,2,4,.500,59,122,.484,.492,21,23,.913,29,75,104,15,6,12,23,44,145
24,Luke Babbitt\babbilu01,PF,23,POR,62,0,730,86,234,.368,62,178,.348,24,56,.429,.500,10,13,.769,15,122,137,29,14,5,22,82,244
25,Leandro Barbosa\barbole01,PG,30,BOS,41,2,513,83,193,.430,18,47,.383,65,146,.445,.477,31,41,.756,8,38,46,58,17,6,21,51,215
26,J.J. Barea\bareajo01,PG,28,MIN,74,2,1713,316,758,.417,97,280,.346,219,478,.458,.481,105,134,.784,34,173,207,294,32,0,145,131,834
27,Andrea Bargnani\bargnan01,PF,27,TOR,35,25,1003,170,426,.399,38,123,.309,132,303,.436,.444,65,77,.844,26,102,128,38,21,23,54,64,443
28,Harrison Barnes\barneha02,SF,20,GSW,81,81,2058,276,628,.439,52,145,.359,224,483,.464,.481,144,190,.758,53,280,333,98,52,14,101,140,748
29,Matt Barnes\barnema02,SF,32,LAC,80,4,2058,312,675,.462,111,325,.342,201,350,.574,.544,87,117,.744,111,255,366,123,82,63,90,233,822
30,Earl Barron\barroea01,C,31,TOT,12,2,159,18,51,.353,0,0,,18,51,.353,.353,3,7,.429,22,39,61,5,5,6,11,24,39
30,Earl Barron\barroea01,C,31,WAS,11,1,122,13,37,.351,0,0,,13,37,.351,.351,2,5,.400,16,27,43,3,5,5,10,23,28
30,Earl Barron\barroea01,C,31,NYK,1,1,37,5,14,.357,0,0,,5,14,.357,.357,1,2,.500,6,12,18,2,0,1,1,1,11
31,Will Barton\bartowi01,SG,22,POR,73,5,894,118,309,.382,9,65,.138,109,244,.447,.396,50,65,.769,36,109,145,58,34,9,60,56,295
32,Brandon Bass\bassbr01,PF,27,BOS,81,69,2239,286,589,.486,0,2,.000,286,587,.487,.486,129,150,.860,129,296,425,84,44,64,80,188,701
33,Shane Battier\battish01,SF,34,MIA,72,20,1786,152,362,.420,136,316,.430,16,46,.348,.608,32,38,.842,37,128,165,72,41,55,34,149,472
34,Nicolas Batum\batumni01,SF,24,POR,73,73,2807,352,833,.423,165,444,.372,187,389,.481,.522,178,210,.848,97,315,412,360,91,83,190,139,1047
35,Jerryd Bayless\bayleje01,PG,24,MEM,80,4,1765,260,621,.419,71,201,.353,189,420,.450,.476,102,122,.836,22,154,176,264,59,17,120,168,693
36,Aron Baynes\baynear01,C,26,SAS,16,0,141,18,36,.500,0,1,.000,18,35,.514,.500,7,12,.583,12,20,32,5,1,6,11,23,43
37,Kent Bazemore\bazemke01,SG,23,GSW,61,0,267,43,116,.371,10,34,.294,33,82,.402,.414,27,44,.614,5,17,22,22,17,4,18,27,123
38,Bradley Beal\bealbr01,SG,19,WAS,56,46,1745,282,687,.410,91,236,.386,191,451,.424,.477,125,159,.786,43,168,211,137,50,29,90,113,780
39,Michael Beasley\beaslmi01,SF,24,PHO,75,20,1554,310,766,.405,45,144,.313,265,622,.426,.434,94,126,.746,52,230,282,111,31,34,144,107,759
40,Rodrigue Beaubois\beaubro01,PG,24,DAL,45,0,549,65,176,.369,21,72,.292,44,104,.423,.429,30,38,.789,9,48,57,84,19,4,33,54,181
41,Marco Belinelli\belinma01,SG,26,CHI,73,27,1882,241,610,.395,79,221,.357,162,389,.416,.460,141,168,.839,13,127,140,148,44,6,82,140,702
42,Patrick Beverley\beverpa01,PG,24,HOU,41,0,713,79,189,.418,36,96,.375,43,93,.462,.513,34,41,.829,45,64,109,117,37,21,44,83,228
43,Andris Biedrins\biedran01,C,26,GSW,53,9,495,10,21,.476,0,0,,10,21,.476,.476,4,13,.308,34,119,153,14,15,42,14,101,24
44,Chauncey Billups\billuch01,SG,36,LAC,22,22,418,53,132,.402,33,90,.367,20,42,.476,.527,45,48,.938,2,30,32,49,12,1,26,25,184
45,Bismack Biyombo\biyombi01,C,20,CHA,80,65,2186,156,346,.451,0,0,,156,346,.451,.451,74,142,.521,194,388,582,35,28,143,82,195,386
46,DeJuan Blair\blairde01,PF,23,SAS,61,16,851,142,271,.524,0,1,.000,142,270,.526,.524,44,70,.629,66,164,230,45,37,10,49,112,328
47,Steve Blake\blakest01,PG,32,LAL,45,13,1175,114,270,.422,72,171,.421,42,99,.424,.556,27,35,.771,21,111,132,173,34,6,62,83,327
48,Andray Blatche\blatcan01,C,26,BRK,82,8,1555,346,676,.512,3,22,.136,343,654,.524,.514,148,216,.685,161,256,417,85,86,54,123,163,843
49,Eric Bledsoe\bledser01,PG,23,LAC,76,12,1553,253,568,.445,31,78,.397,222,490,.453,.473,106,134,.791,78,147,225,233,109,55,137,112,643
50,Keith Bogans\boganke01,SG,32,BRK,74,23,1408,108,284,.380,84,245,.343,24,39,.615,.528,11,17,.647,16,104,120,76,28,4,49,108,311
51,Andrew Bogut\bogutan01,C,28,GSW,32,32,786,83,184,.451,1,1,1.000,82,183,.448,.454,19,38,.500,68,177,245,67,20,55,35,85,186
52,Matt Bonner\bonnema01,PF,32,SAS,68,4,909,112,230,.487,53,120,.442,59,110,.536,.602,11,15,.733,25,104,129,36,17,19,16,86,288
53,Trevor Booker\booketr01,PF,25,WAS,48,14,887,108,220,.491,0,5,.000,108,215,.502,.491,40,72,.556,98,141,239,40,32,16,31,95,256
54,Carlos Boozer\boozeca01,PF,31,CHI,79,79,2546,544,1140,.477,0,2,.000,544,1138,.478,.477,193,264,.731,175,596,771,179,66,28,176,239,1281
55,Chris Bosh\boshch01,C,28,MIA,74,74,2454,485,907,.535,21,74,.284,464,833,.557,.546,241,302,.798,131,370,501,123,66,101,128,168,1232
56,Avery Bradley\bradlav01,PG,22,BOS,50,50,1435,192,478,.402,40,126,.317,152,352,.432,.444,37,49,.755,30,81,111,104,64,19,72,129,461
57,Elton Brand\brandel01,C,33,DAL,72,18,1527,226,478,.473,0,1,.000,226,477,.474,.473,66,93,.710,130,300,430,70,50,90,57,192,518
58,Corey Brewer\breweco01,SF,26,DEN,82,2,2003,375,883,.425,91,307,.296,284,576,.493,.476,149,216,.690,55,180,235,124,118,23,102,154,990
59,Ronnie Brewer\brewero02,SF,27,TOT,60,34,853,70,198,.354,23,76,.303,47,122,.385,.412,16,39,.410,42,98,140,50,43,6,18,33,179
59,Ronnie Brewer\brewero02,SF,27,NYK,46,34,711,64,175,.366,22,71,.310,42,104,.404,.429,16,39,.410,29,71,100,40,34,6,14,27,166
59,Ronnie Brewer\brewero02,SF,27,OKC,14,0,142,6,23,.261,1,5,.200,5,18,.278,.283,0,0,,13,27,40,10,9,0,4,6,13
60,Aaron Brooks\brookaa01,PG,28,TOT,53,20,997,143,316,.453,50,134,.373,93,182,.511,.532,40,52,.769,13,67,80,114,30,10,67,94,376
60,Aaron Brooks\brookaa01,PG,28,SAC,46,20,959,139,303,.459,48,127,.378,91,176,.517,.538,40,52,.769,12,66,78,108,29,7,63,89,366
60,Aaron Brooks\brookaa01,PG,28,HOU,7,0,38,4,13,.308,2,7,.286,2,6,.333,.385,0,0,,1,1,2,6,1,3,4,5,10
61,MarShon Brooks\brookma01,SG,24,BRK,73,2,912,155,335,.463,15,55,.273,140,280,.500,.485,69,94,.734,32,72,104,76,34,16,69,93,394
62,Kwame Brown\brownkw01,C,30,PHI,22,11,269,17,37,.459,0,0,,17,37,.459,.459,7,19,.368,23,51,74,9,6,10,8,37,41
63,Shannon Brown\brownsh01,SG,27,PHO,59,22,1402,240,571,.420,39,141,.277,201,430,.467,.454,98,125,.784,44,105,149,108,59,15,74,92,617
64,Kobe Bryant\bryanko01,SG,34,LAL,78,78,3013,738,1595,.463,132,407,.324,606,1188,.510,.504,525,626,.839,66,367,433,469,106,25,287,173,2133
65,Chase Budinger\budinch01,SF,24,MIN,23,1,508,79,191,.414,26,81,.321,53,110,.482,.482,32,42,.762,15,56,71,25,14,7,23,29,216
66,Alec Burks\burksal01,SG,21,UTA,64,0,1137,163,388,.420,33,92,.359,130,296,.439,.463,92,129,.713,37,108,145,92,35,13,74,114,451
67,Caron Butler\butleca01,SF,32,LAC,78,78,1879,305,720,.424,128,330,.388,177,390,.454,.513,75,90,.833,41,182,223,78,51,11,72,139,813
68,Jimmy Butler\butleji01,SF,23,CHI,82,20,2134,239,512,.467,40,105,.381,199,407,.489,.506,187,233,.803,136,192,328,115,78,31,62,97,705
69,Will Bynum\bynumwi01,PG,30,DET,65,0,1219,253,540,.469,24,76,.316,229,464,.494,.491,106,131,.809,28,69,97,231,45,5,125,128,636
70,Jose Calderon\caldejo01,PG,31,TOT,73,58,2160,312,635,.491,130,282,.461,182,353,.516,.594,72,80,.900,20,156,176,518,58,8,126,99,826
70,Jose Calderon\caldejo01,PG,31,TOR,45,30,1273,187,398,.470,79,184,.429,108,214,.505,.569,47,52,.904,14,92,106,333,28,6,75,58,500
70,Jose Calderon\caldejo01,PG,31,DET,28,28,887,125,237,.527,51,98,.520,74,139,.532,.635,25,28,.893,6,64,70,185,30,2,51,41,326
71,Marcus Camby\cambyma01,PF,38,NYK,24,4,250,17,53,.321,0,0,,17,53,.321,.321,8,19,.421,24,56,80,14,7,14,15,28,42
72,DeMarre Carroll\carrode01,SF,26,UTA,66,12,1111,149,324,.460,20,70,.286,129,254,.508,.491,75,98,.765,87,101,188,61,58,24,34,119,393
73,Matt Carroll\carroma01,SG,32,CHA,1,0,6,0,0,,0,0,,0,0,,,0,0,,0,0,0,1,0,0,0,1,0
74,Vince Carter\cartevi01,SF,36,DAL,81,3,2093,372,855,.435,162,399,.406,210,456,.461,.530,182,223,.816,58,276,334,194,74,44,106,226,1088
75,Omri Casspi\casspom01,SF,24,CLE,43,1,503,63,160,.394,25,76,.329,38,84,.452,.472,22,41,.537,20,94,114,28,25,12,22,45,173
76,Mario Chalmers\chalmma01,PG,26,MIA,77,77,2068,227,529,.429,123,301,.409,104,228,.456,.545,89,112,.795,19,152,171,273,118,12,119,196,666
77,Tyson Chandler\chandty01,C,30,NYK,66,66,2164,255,400,.638,0,0,,255,400,.638,.638,179,258,.694,269,434,703,62,42,75,87,188,689
78,Wilson Chandler\chandwi01,PF,25,DEN,43,8,1079,210,455,.462,52,126,.413,158,329,.480,.519,88,111,.793,45,173,218,58,45,12,60,119,560
79,Josh Childress\childjo01,SF,29,BRK,14,0,100,6,21,.286,1,3,.333,5,18,.278,.310,1,2,.500,6,9,15,5,2,2,0,3,14
80,Earl Clark\clarkea01,PF,25,LAL,59,36,1363,170,386,.440,35,104,.337,135,282,.479,.486,53,76,.697,82,243,325,65,36,44,62,102,428
81,Victor Claver\clavevi01,SF,24,POR,49,16,812,74,189,.392,25,87,.287,49,102,.480,.458,14,30,.467,31,88,119,43,26,12,43,75,187
82,Norris Cole\coleno01,PG,24,MIA,80,4,1590,179,425,.421,35,98,.357,144,327,.440,.462,52,80,.650,18,112,130,164,57,7,104,155,445
83,Jason Collins\collija04,C,34,TOT,38,9,384,9,29,.310,0,0,,9,29,.310,.310,23,32,.719,22,38,60,8,12,10,18,85,41
83,Jason Collins\collija04,C,34,BOS,32,7,330,8,23,.348,0,0,,8,23,.348,.348,21,30,.700,21,31,52,6,10,6,16,74,37
83,Jason Collins\collija04,C,34,WAS,6,2,54,1,6,.167,0,0,,1,6,.167,.167,2,2,1.000,1,7,8,2,2,4,2,11,4
84,Darren Collison\collida01,PG,25,DAL,81,47,2372,341,724,.471,48,136,.353,293,588,.498,.504,242,275,.880,31,188,219,415,100,8,173,139,972
85,Nick Collison\collini01,C,32,OKC,81,2,1583,176,296,.595,0,4,.000,176,292,.603,.595,60,78,.769,123,210,333,121,51,30,69,197,412
86,Mike Conley\conlemi01,PG,25,MEM,80,80,2757,414,940,.440,106,293,.362,308,647,.476,.497,234,282,.830,43,182,225,487,174,24,189,171,1168
87,Will Conroy\conrowi01,PG,30,MIN,4,0,20,0,9,.000,0,3,.000,0,6,.000,.000,1,2,.500,1,0,1,0,0,0,0,1,1
88,Daequan Cook\cookda02,SG,25,TOT,49,1,441,51,167,.305,26,91,.286,25,76,.329,.383,9,12,.750,7,54,61,19,8,7,15,26,137
88,Daequan Cook\cookda02,SG,25,HOU,16,1,165,21,59,.356,11,30,.367,10,29,.345,.449,2,3,.667,5,13,18,10,6,2,6,13,55
88,Daequan Cook\cookda02,SG,25,CHI,33,0,276,30,108,.278,15,61,.246,15,47,.319,.347,7,9,.778,2,41,43,9,2,5,9,13,82
89,Chris Copeland\copelch01,PF,28,NYK,56,13,862,182,380,.479,59,140,.421,123,240,.513,.557,63,83,.759,34,85,119,27,16,12,50,104,486
90,DeMarcus Cousins\couside01,C,22,SAC,75,74,2289,482,1036,.465,4,22,.182,478,1014,.471,.467,312,423,.738,222,524,746,199,108,55,225,269,1280
91,Jamal Crawford\crawfja01,SG,32,LAC,76,0,2230,445,1016,.438,149,396,.376,296,620,.477,.511,216,248,.871,22,106,128,193,79,13,146,71,1255
92,Jordan Crawford\crawfjo02,SG,24,TOT,70,14,1709,301,725,.415,83,246,.337,218,479,.455,.472,129,159,.811,44,165,209,225,39,7,141,106,814
92,Jordan Crawford\crawfjo02,SG,24,WAS,43,12,1127,211,508,.415,59,171,.345,152,337,.451,.473,87,106,.821,31,104,135,157,27,5,97,61,568
92,Jordan Crawford\crawfjo02,SG,24,BOS,27,2,582,90,217,.415,24,75,.320,66,142,.465,.470,42,53,.792,13,61,74,68,12,2,44,45,246
93,Jae Crowder\crowdja01,SF,22,DAL,78,16,1353,141,367,.384,63,192,.328,78,175,.446,.470,47,73,.644,35,152,187,94,63,17,49,128,392
94,Dante Cunningham\cunnida01,PF,25,MIN,80,9,2010,314,671,.468,0,6,.000,314,665,.472,.468,67,103,.650,142,266,408,67,84,38,56,153,695
95,Jared Cunningham\cunnija01,SG,21,DAL,8,0,26,6,14,.429,2,3,.667,4,11,.364,.500,2,2,1.000,1,2,3,1,1,0,2,3,16
96,Eddy Curry\curryed01,C,30,DAL,2,0,25,4,8,.500,0,0,,4,8,.500,.500,1,4,.250,2,2,4,0,0,0,3,7,9
97,Stephen Curry\curryst01,PG,24,GSW,78,78,2983,626,1388,.451,272,600,.453,354,788,.449,.549,262,291,.900,59,255,314,539,126,12,240,198,1786
98,Samuel Dalembert\dalemsa01,C,31,MIL,47,23,765,137,253,.542,1,1,1.000,136,252,.540,.543,38,55,.691,105,171,276,21,17,53,51,90,313
99,Marquis Daniels\daniema01,SF,32,MIL,59,33,1085,132,351,.376,20,72,.278,112,279,.401,.405,40,54,.741,48,102,150,65,51,10,45,77,324
100,Anthony Davis\davisan02,PF,19,NOH,64,60,1846,349,676,.516,0,6,.000,349,670,.521,.516,169,225,.751,165,357,522,63,75,112,89,158,867
101,Ed Davis\davised01,C-PF,23,TOT,81,28,1631,260,482,.539,0,0,,260,482,.539,.539,103,167,.617,152,308,460,63,38,85,63,191,623
101,Ed Davis\davised01,C,23,TOR,45,24,1087,186,339,.549,0,0,,186,339,.549,.549,66,102,.647,95,205,300,55,25,38,45,111,438
101,Ed Davis\davised01,PF,23,MEM,36,4,544,74,143,.517,0,0,,74,143,.517,.517,37,65,.569,57,103,160,8,13,47,18,80,185
102,Glen Davis\davisgl01,PF,27,ORL,34,33,1064,214,478,.448,0,2,.000,214,476,.450,.448,84,117,.718,55,191,246,70,32,21,64,88,512
103,Austin Daye\dayeau01,SF,24,TOT,55,0,676,90,208,.433,41,98,.418,49,110,.445,.531,26,34,.765,16,107,123,42,14,22,29,82,247
103,Austin Daye\dayeau01,SF,24,DET,24,0,348,43,97,.443,21,40,.525,22,57,.386,.552,15,18,.833,10,53,63,21,5,8,13,43,122
103,Austin Daye\dayeau01,SF,24,MEM,31,0,328,47,111,.423,20,58,.345,27,53,.509,.514,11,16,.688,6,54,60,21,9,14,16,39,125
104,Nando De Colo\decolna01,SG,25,SAS,72,6,920,105,241,.436,31,82,.378,74,159,.465,.500,35,44,.795,23,115,138,138,41,6,81,87,276
105,Carlos Delfino\delfica01,SF,30,HOU,67,5,1689,251,620,.405,158,421,.375,93,199,.467,.532,48,56,.857,18,202,220,135,68,9,72,114,708
106,Luol Deng\denglu01,SF,27,CHI,75,75,2903,466,1093,.426,75,233,.322,391,860,.455,.461,230,282,.816,162,314,476,222,81,32,144,105,1237
107,Justin Dentmon\dentmju01,PG,27,DAL,2,0,4,0,2,.000,0,0,,0,2,.000,.000,0,0,,0,0,0,0,0,0,0,0,0
108,DeMar DeRozan\derozde01,SG,23,TOR,82,82,3013,548,1231,.445,34,120,.283,514,1111,.463,.459,355,427,.831,48,272,320,204,76,24,151,173,1485
109,Boris Diaw\diawbo01,PF,30,SAS,75,20,1709,179,332,.539,30,78,.385,149,254,.587,.584,47,65,.723,66,188,254,180,52,27,84,143,435
110,DeSagana Diop\diopde01,C,31,CHA,22,1,226,8,27,.296,0,1,.000,8,26,.308,.296,0,1,.000,10,41,51,13,5,16,8,19,16
111,Keyon Dooling\doolike01,PG,32,MEM,7,0,82,10,21,.476,5,12,.417,5,9,.556,.595,6,7,.857,0,1,1,8,1,0,5,8,31
112,Toney Douglas\douglto01,PG,26,TOT,71,0,1289,188,466,.403,82,216,.380,106,250,.424,.491,76,84,.905,34,104,138,151,71,3,81,145,534
112,Toney Douglas\douglto01,PG,26,HOU,49,0,913,139,352,.395,61,162,.377,78,190,.411,.482,60,68,.882,23,67,90,93,40,2,56,103,399
112,Toney Douglas\douglto01,PG,26,SAC,22,0,376,49,114,.430,21,54,.389,28,60,.467,.522,16,16,1.000,11,37,48,58,31,1,25,42,135
113,Chris Douglas-Roberts\douglch01,SG,26,DAL,6,0,63,5,14,.357,0,4,.000,5,10,.500,.357,7,10,.700,0,5,5,4,2,0,1,4,17
114,Goran Dragic\dragigo01,PG,26,PHO,77,77,2581,401,906,.443,88,276,.319,313,630,.497,.491,244,326,.748,60,178,238,569,124,26,212,214,1134
115,Andre Drummond\drumman01,C,19,DET,60,10,1243,208,342,.608,1,2,.500,207,340,.609,.610,59,159,.371,169,288,457,30,59,95,57,144,476
116,Jared Dudley\dudleja01,SF,27,PHO,79,50,2170,313,669,.468,106,271,.391,207,398,.520,.547,129,162,.796,79,166,245,203,75,8,101,128,861
117,Chris Duhon\duhonch01,PG,30,LAL,46,9,820,47,123,.382,33,91,.363,14,32,.438,.516,6,13,.462,11,57,68,133,20,1,40,56,133
118,Tim Duncan\duncati01,C,36,SAS,69,69,2078,490,976,.502,2,7,.286,488,969,.504,.503,245,300,.817,124,562,686,184,50,183,147,117,1227
119,Mike Dunleavy\dunlemi02,SF,32,MIL,75,3,1943,276,624,.442,128,299,.428,148,325,.455,.545,105,128,.820,31,260,291,145,39,35,90,135,785
120,Kevin Durant\duranke01,SF,24,OKC,81,81,3119,731,1433,.510,139,334,.416,592,1099,.539,.559,679,750,.905,46,594,640,374,116,105,280,143,2280
121,Devin Ebanks\ebankde01,SF,23,LAL,19,3,197,24,73,.329,6,22,.273,18,51,.353,.370,11,14,.786,10,31,41,10,3,1,11,23,65
122,Wayne Ellington\ellinwa01,SG,25,TOT,78,21,1661,226,529,.427,94,240,.392,132,289,.457,.516,68,75,.907,25,141,166,104,45,3,57,81,614
122,Wayne Ellington\ellinwa01,SG,25,MEM,40,4,676,81,199,.407,41,97,.423,40,102,.392,.510,15,16,.938,5,47,52,42,16,1,24,38,218
122,Wayne Ellington\ellinwa01,SG,25,CLE,38,17,985,145,330,.439,53,143,.371,92,187,.492,.520,53,59,.898,20,94,114,62,29,2,33,43,396
123,Monta Ellis\ellismo01,SG,27,MIL,82,82,3076,597,1436,.416,94,328,.287,503,1108,.454,.448,289,374,.773,45,271,316,496,169,36,254,164,1577
124,Kim English\engliki01,SG,24,DET,41,0,407,42,112,.375,14,50,.280,28,62,.452,.438,21,29,.724,8,29,37,26,16,3,19,46,119
125,Jeremy Evans\evansje01,PF,25,UTA,37,0,215,27,44,.614,0,1,.000,27,43,.628,.614,21,33,.636,26,32,58,11,8,13,8,30,75
126,Reggie Evans\evansre01,PF,32,BRK,80,56,1967,125,261,.479,0,0,,125,261,.479,.479,113,222,.509,260,628,888,43,74,13,111,199,363
127,Tyreke Evans\evansty01,SG,23,SAC,65,61,2016,366,765,.478,45,133,.338,321,632,.508,.508,210,271,.775,56,231,287,229,90,27,128,133,987
128,Festus Ezeli\ezelife01,C,23,GSW,78,41,1120,74,169,.438,0,0,,74,169,.438,.438,43,81,.531,141,172,313,22,23,74,63,157,191
129,Kenneth Faried\farieke01,PF,23,DEN,80,80,2248,380,689,.552,0,0,,380,689,.552,.552,163,266,.613,260,474,734,77,81,83,113,234,923
130,Derrick Favors\favorde01,PF,21,UTA,77,8,1787,274,568,.482,0,5,.000,274,563,.487,.482,179,260,.688,184,362,546,75,67,130,129,247,727
131,Raymond Felton\feltora01,PG,28,NYK,68,68,2313,377,882,.427,93,258,.360,284,624,.455,.480,101,128,.789,51,143,194,372,94,14,155,130,948
132,Landry Fields\fieldla01,SF,24,TOR,51,22,1037,102,223,.457,2,14,.143,100,209,.478,.462,34,53,.642,59,149,208,60,32,8,42,63,240
133,Derek Fisher\fishede01,SG-PG,38,TOT,33,9,575,55,161,.342,30,80,.375,25,81,.309,.435,35,38,.921,2,35,37,47,19,3,30,55,175
133,Derek Fisher\fishede01,PG,38,DAL,9,9,229,23,65,.354,10,23,.435,13,42,.310,.431,21,23,.913,0,15,15,31,5,2,18,24,77
133,Derek Fisher\fishede01,SG,38,OKC,24,0,346,32,96,.333,20,57,.351,12,39,.308,.438,14,15,.933,2,20,22,16,14,1,12,31,98
134,Evan Fournier\fournev01,SG,20,DEN,38,4,428,75,152,.493,22,54,.407,53,98,.541,.566,30,39,.769,6,29,35,44,19,1,32,65,202
135,Randy Foye\foyera01,SG,29,UTA,82,72,2249,293,738,.397,178,434,.410,115,304,.378,.518,118,144,.819,17,110,127,167,66,27,92,190,882
136,Jimmer Fredette\fredeji01,SG,23,SAC,69,0,967,172,409,.421,65,156,.417,107,253,.423,.500,85,99,.859,19,52,71,92,31,3,68,64,494
137,Joel Freeland\freeljo01,PF,25,POR,51,1,477,58,142,.408,0,0,,58,142,.408,.408,18,27,.667,40,79,119,13,13,11,19,67,134
138,Danilo Gallinari\gallida01,SF,24,DEN,71,71,2309,364,871,.418,135,362,.373,229,509,.450,.495,286,348,.822,65,302,367,176,64,36,111,130,1149
139,Francisco Garcia\garcifr01,SG-SF,31,TOT,58,20,1029,118,300,.393,67,179,.374,51,121,.421,.505,18,21,.857,8,83,91,63,46,38,32,88,321
139,Francisco Garcia\garcifr01,SG,31,SAC,40,15,710,77,205,.376,40,109,.367,37,96,.385,.473,12,14,.857,7,61,68,43,32,31,20,66,206
139,Francisco Garcia\garcifr01,SF,31,HOU,18,5,319,41,95,.432,27,70,.386,14,25,.560,.574,6,7,.857,1,22,23,20,14,7,12,22,115
140,Kevin Garnett\garneke01,C,36,BOS,68,68,2022,422,850,.496,2,16,.125,420,834,.504,.498,158,201,.786,75,455,530,159,78,62,110,154,1004
141,Diante Garrett\garredi02,PG,24,PHO,19,0,149,16,49,.327,3,15,.200,13,34,.382,.357,5,10,.500,5,10,15,31,10,0,16,5,40
142,Marc Gasol\gasolma01,C,28,MEM,80,80,2796,429,869,.494,1,14,.071,428,855,.501,.494,268,316,.848,184,438,622,318,80,139,157,255,1127
143,Pau Gasol\gasolpa01,PF,32,LAL,49,42,1655,270,579,.466,8,28,.286,262,551,.475,.473,125,178,.702,111,310,421,200,24,61,104,93,673
144,Rudy Gay\gayru01,SF,26,TOT,75,74,2687,521,1253,.416,84,260,.323,437,993,.440,.449,240,295,.814,99,362,461,202,113,53,198,182,1366
144,Rudy Gay\gayru01,SF,26,MEM,42,42,1541,281,688,.408,40,129,.310,241,559,.431,.438,121,156,.776,56,193,249,108,56,31,104,87,723
144,Rudy Gay\gayru01,SF,26,TOR,33,32,1146,240,565,.425,44,131,.336,196,434,.452,.464,119,139,.856,43,169,212,94,57,22,94,95,643
145,Alonzo Gee\geeal01,SF,25,CLE,82,82,2541,305,744,.410,69,219,.315,236,525,.450,.456,163,205,.795,75,245,320,133,107,29,132,199,842
146,Mickael Gelabale\gelabmi01,SF,29,MIN,36,13,644,72,139,.518,16,52,.308,56,87,.644,.576,21,24,.875,32,67,99,26,16,4,16,47,181
147,Paul George\georgpa01,SF,22,IND,79,79,2972,493,1176,.419,170,469,.362,323,707,.457,.491,221,274,.807,88,515,603,327,143,51,233,227,1377
148,Daniel Gibson\gibsoda01,PG,26,CLE,46,3,919,84,247,.340,56,163,.344,28,84,.333,.453,26,37,.703,5,55,60,82,30,4,31,89,250
149,Taj Gibson\gibsota01,PF,27,CHI,65,5,1459,214,441,.485,0,4,.000,214,437,.490,.485,89,131,.679,125,220,345,61,27,90,76,166,517
150,Manu Ginobili\ginobma01,SG,35,SAS,60,0,1393,229,539,.425,83,235,.353,146,304,.480,.502,164,206,.796,30,171,201,274,80,13,132,114,705
151,Drew Gooden\goodedr01,C,31,MIL,16,0,151,20,61,.328,1,5,.200,19,56,.339,.336,11,16,.688,13,18,31,6,5,6,9,21,52
152,Ben Gordon\gordobe01,SG,29,CHA,75,0,1560,310,760,.408,113,292,.387,197,468,.421,.482,107,127,.843,18,112,130,141,35,16,136,134,840
153,Eric Gordon\gordoer01,SG,24,NOH,42,40,1264,235,584,.402,56,173,.324,179,411,.436,.450,187,222,.842,10,67,77,137,45,8,117,75,713
154,Marcin Gortat\gortama01,C,28,PHO,61,61,1876,295,566,.521,0,3,.000,295,563,.524,.521,90,138,.652,128,388,516,75,40,98,99,127,680
155,Andrew Goudelock\goudean01,SG,24,LAL,1,0,6,0,2,.000,0,0,,0,2,.000,.000,0,0,,1,0,1,0,0,0,0,0,0
156,Danny Granger\grangda01,SF,29,IND,5,0,74,10,35,.286,2,10,.200,8,25,.320,.314,5,8,.625,3,6,9,3,2,1,4,6,27
157,Aaron Gray\grayaa01,C,28,TOR,42,16,513,48,90,.533,0,0,,48,90,.533,.533,23,44,.523,48,85,133,33,7,5,36,85,119
158,Danny Green\greenda02,SG,25,SAS,80,80,2201,297,663,.448,177,413,.429,120,250,.480,.581,67,79,.848,36,208,244,141,92,54,94,124,838
159,Draymond Green\greendr01,SF,22,GSW,79,1,1061,84,257,.327,14,67,.209,70,190,.368,.354,45,55,.818,58,202,260,53,42,25,51,159,227
160,Gerald Green\greenge01,SF,27,IND,60,7,1080,155,424,.366,59,188,.314,96,236,.407,.435,52,65,.800,31,110,141,50,19,23,53,64,421
161,Jeff Green\greenje02,PF,26,BOS,81,17,2252,376,806,.467,70,182,.385,306,624,.490,.510,214,265,.808,55,263,318,128,56,68,132,175,1036
162,Willie Green\greenwi01,SG,31,LAC,72,60,1188,178,386,.461,71,166,.428,107,220,.486,.553,23,32,.719,17,80,97,55,29,12,31,96,450
163,Blake Griffin\griffbl01,PF,23,LAC,80,80,2598,577,1072,.538,5,28,.179,572,1044,.548,.541,281,426,.660,186,476,662,299,97,50,185,231,1440
164,Hamed Haddadi\haddaha01,C,27,TOT,30,0,322,35,82,.427,0,0,,35,82,.427,.427,14,27,.519,43,68,111,12,6,27,31,60,84
164,Hamed Haddadi\haddaha01,C,27,MEM,13,0,87,7,21,.333,0,0,,7,21,.333,.333,1,2,.500,10,14,24,4,1,6,4,15,15
164,Hamed Haddadi\haddaha01,C,27,PHO,17,0,235,28,61,.459,0,0,,28,61,.459,.459,13,25,.520,33,54,87,8,5,21,27,45,69
165,Jordan Hamilton\hamiljo02,SF,22,DEN,40,1,397,84,201,.418,27,73,.370,57,128,.445,.485,13,26,.500,32,63,95,23,15,8,19,24,208
166,Richard Hamilton\hamilri01,SG,34,CHI,50,45,1088,204,475,.429,16,52,.308,188,423,.444,.446,66,77,.857,16,67,83,119,24,5,84,93,490
167,Ben Hansbrough\hansbbe01,PG,25,IND,28,0,200,15,45,.333,6,23,.261,9,22,.409,.400,21,27,.778,2,16,18,21,7,2,18,23,57
168,Tyler Hansbrough\hansbty01,PF,27,IND,81,8,1366,176,407,.432,0,3,.000,176,404,.436,.432,216,300,.720,161,212,373,36,29,18,78,152,568
169,James Harden\hardeja01,SG,23,HOU,78,78,2985,585,1337,.438,179,486,.368,406,851,.477,.504,674,792,.851,62,317,379,455,142,38,295,178,2023
170,Maurice Harkless\harklma01,SF,19,ORL,76,59,1974,260,564,.461,32,117,.274,228,447,.510,.489,73,128,.570,122,213,335,50,88,62,69,144,625
171,Josh Harrellson\harrejo01,C,23,MIA,6,0,31,4,9,.444,1,5,.200,3,4,.750,.500,1,2,.500,3,4,7,0,1,1,3,4,10
172,Al Harrington\harrial01,C,32,ORL,10,0,119,20,57,.351,8,30,.267,12,27,.444,.421,3,4,.750,6,21,27,10,4,1,7,18,51
173,Devin Harris\harride01,SG,29,ATL,58,34,1421,194,443,.438,77,230,.335,117,213,.549,.525,112,154,.727,6,110,116,197,64,13,88,103,577
174,Terrel Harris\harrite01,SG,25,TOT,20,0,137,4,27,.148,0,8,.000,4,19,.211,.148,7,10,.700,4,22,26,9,2,3,17,17,15
174,Terrel Harris\harrite01,SG,25,MIA,7,0,29,2,8,.250,0,1,.000,2,7,.286,.250,6,8,.750,4,5,9,2,0,0,4,3,10
174,Terrel Harris\harrite01,SG,25,NOH,13,0,108,2,19,.105,0,7,.000,2,12,.167,.105,1,2,.500,0,17,17,7,2,3,13,14,5
175,Tobias Harris\harrito02,SF-PF,20,TOT,55,34,1299,233,512,.455,34,108,.315,199,404,.493,.488,103,137,.752,73,214,287,69,32,44,66,120,603
175,Tobias Harris\harrito02,SF,20,MIL,28,14,325,53,115,.461,7,21,.333,46,94,.489,.491,23,26,.885,17,40,57,13,8,7,18,31,136
175,Tobias Harris\harrito02,PF,20,ORL,27,20,974,180,397,.453,27,87,.310,153,310,.494,.487,80,111,.721,56,174,230,56,24,37,48,89,467
176,Udonis Haslem\hasleud01,PF,32,MIA,75,59,1414,129,251,.514,0,0,,129,251,.514,.514,32,45,.711,97,307,404,38,30,15,45,173,290
177,Spencer Hawes\hawessp01,C,24,PHI,82,40,2233,376,811,.464,31,87,.356,345,724,.477,.483,122,157,.777,173,417,590,183,24,113,131,233,905
178,Chuck Hayes\hayesch01,C,29,SAC,74,1,1209,84,190,.442,0,1,.000,84,189,.444,.442,30,48,.625,113,186,299,112,31,18,44,114,198
179,Gordon Hayward\haywago01,SF,22,UTA,72,27,2104,336,773,.435,102,246,.415,234,527,.444,.501,243,294,.827,51,174,225,213,58,38,120,125,1017
180,Lazar Hayward\haywala01,SF,26,MIN,4,0,31,2,10,.200,0,4,.000,2,6,.333,.200,6,6,1.000,0,4,4,3,2,0,0,3,10
181,Brendan Haywood\haywobr01,C,33,CHA,61,17,1162,93,216,.431,0,1,.000,93,215,.433,.431,30,66,.455,125,165,290,29,16,49,50,125,216
182,Gerald Henderson\hendege02,SG,25,CHA,68,58,2133,382,855,.447,33,100,.330,349,755,.462,.466,258,313,.824,55,195,250,177,68,34,108,149,1055
183,Xavier Henry\henryxa01,SF,21,NOH,50,2,625,66,161,.410,4,11,.364,62,150,.413,.422,58,92,.630,21,69,90,13,16,5,31,72,194
184,John Henson\hensojo01,PF,22,MIL,63,9,827,162,336,.482,0,3,.000,162,333,.486,.482,56,105,.533,116,181,297,31,19,42,47,83,380
185,Roy Hibbert\hibbero01,C,26,IND,79,79,2269,385,859,.448,1,4,.250,384,855,.449,.449,166,224,.741,296,360,656,113,39,206,162,279,937
186,J.J. Hickson\hicksjj01,C,24,POR,80,80,2323,418,744,.562,0,2,.000,418,742,.563,.562,182,268,.679,266,562,828,88,48,51,145,160,1018
187,Cory Higgins\higgico01,SG,23,CHA,6,0,32,6,19,.316,1,5,.200,5,14,.357,.342,1,2,.500,1,2,3,5,3,0,0,5,14
188,Nene Hilario\hilarne01,PF,30,WAS,61,49,1659,285,594,.480,0,1,.000,285,593,.481,.480,196,269,.729,101,306,407,177,55,37,139,171,766
189,George Hill\hillge01,PG,26,IND,76,76,2620,386,871,.443,130,353,.368,256,518,.494,.518,174,213,.817,47,237,284,355,81,26,116,134,1076
190,Grant Hill*\hillgr01,SF,40,LAC,29,0,437,38,98,.388,3,11,.273,35,87,.402,.403,14,24,.583,6,43,49,26,11,7,25,39,93
191,Jordan Hill\hilljo01,PF,25,LAL,29,1,458,77,155,.497,0,2,.000,77,153,.503,.497,40,61,.656,82,84,166,13,8,19,26,55,194
192,Kirk Hinrich\hinriki01,PG,32,CHI,60,60,1764,159,422,.377,71,182,.390,88,240,.367,.461,70,98,.714,16,142,158,314,63,25,99,192,459
193,Jrue Holiday\holidjr01,PG,22,PHI,78,78,2926,555,1288,.431,91,247,.368,464,1041,.446,.466,182,242,.752,89,240,329,625,123,32,292,170,1383
194,Justin Holiday\holidju01,SG,23,PHI,9,0,142,16,48,.333,4,16,.250,12,32,.375,.375,6,8,.750,0,14,14,15,3,6,9,7,42
195,Ryan Hollins\holliry01,C,28,LAC,60,0,663,70,114,.614,0,0,,70,114,.614,.614,66,88,.750,50,89,139,11,6,34,44,133,206
196,Tyler Honeycutt\honeyty01,SF,22,SAC,9,0,32,3,11,.273,0,2,.000,3,9,.333,.273,2,2,1.000,3,7,10,2,0,1,5,2,8
197,Al Horford\horfoal01,C,26,ATL,74,74,2756,576,1060,.543,3,6,.500,573,1054,.544,.545,134,208,.644,195,562,757,240,78,78,147,163,1289
198,Dwight Howard\howardw01,C,27,LAL,76,76,2722,470,813,.578,1,6,.167,469,807,.581,.579,355,721,.492,251,694,945,108,84,186,225,291,1296
199,Josh Howard\howarjo01,SF,32,MIN,11,4,207,31,77,.403,5,16,.313,26,61,.426,.435,7,12,.583,9,27,36,4,10,3,10,18,74
200,Juwan Howard\howarju01,PF,39,MIA,7,2,51,10,19,.526,0,0,,10,19,.526,.526,1,1,1.000,0,8,8,6,0,0,4,9,21
201,Kris Humphries\humphkr01,PF,27,BRK,65,21,1191,139,310,.448,0,2,.000,139,308,.451,.448,97,123,.789,126,239,365,32,16,33,57,127,375
202,Serge Ibaka\ibakase01,PF,23,OKC,80,80,2486,446,778,.573,20,57,.351,426,721,.591,.586,143,191,.749,222,395,617,43,28,242,125,213,1055
203,Andre Iguodala\iguodan01,SG,29,DEN,80,80,2779,396,879,.451,91,287,.317,305,592,.515,.502,155,270,.574,82,341,423,433,139,52,206,127,1038
204,Ersan Ilyasova\ilyaser01,PF,25,MIL,73,54,2012,371,803,.462,95,214,.444,276,589,.469,.521,125,157,.796,154,366,520,117,68,36,75,185,962
205,Kyrie Irving\irvinky01,PG,20,CLE,59,59,2048,484,1070,.452,109,279,.391,375,791,.474,.503,248,290,.855,34,182,216,350,89,21,191,146,1325
206,Royal Ivey\iveyro01,SG,31,PHI,53,5,698,62,144,.431,37,88,.420,25,56,.446,.559,9,16,.563,16,41,57,32,23,3,20,73,170
207,Jarrett Jack\jackja01,SG,29,GSW,79,4,2349,387,857,.452,82,203,.404,305,654,.466,.499,167,198,.843,21,222,243,439,60,11,157,134,1023
208,Reggie Jackson\jacksre01,PG,22,OKC,70,0,993,149,325,.458,24,104,.231,125,221,.566,.495,52,62,.839,21,145,166,122,29,13,53,84,374
209,Stephen Jackson\jacksst02,SF,34,SAS,55,6,1075,123,330,.373,46,170,.271,77,160,.481,.442,49,70,.700,22,133,155,80,37,14,77,89,341
210,Bernard James\jamesbe01,C,27,DAL,46,11,457,53,103,.515,0,2,.000,53,101,.525,.515,25,41,.610,52,79,131,6,12,38,18,64,131
211,Damion James\jamesda01,SF,25,BRK,2,0,0,0,0,,0,0,,0,0,,,0,0,,0,1,1,0,0,0,0,0,0
212,LeBron James\jamesle01,PF,28,MIA,76,76,2877,765,1354,.565,103,254,.406,662,1100,.602,.603,403,535,.753,97,513,610,551,129,67,226,110,2036
213,Mike James\jamesmi01,PG,37,DAL,45,23,862,101,271,.373,48,125,.384,53,146,.363,.461,23,29,.793,9,63,72,139,26,3,55,95,273
214,Antawn Jamison\jamisan01,PF,36,LAL,76,6,1636,267,575,.464,84,233,.361,183,342,.535,.537,94,136,.691,109,253,362,50,30,22,53,124,712
215,Al Jefferson\jeffeal01,C,28,UTA,78,78,2578,611,1236,.494,2,17,.118,609,1219,.500,.495,167,217,.770,156,564,720,164,80,89,105,170,1391
216,Richard Jefferson\jefferi01,SF,32,GSW,56,1,568,62,136,.456,14,45,.311,48,91,.527,.507,38,53,.717,5,79,84,31,14,7,23,45,176
217,Jared Jeffries\jeffrja01,PF,31,POR,38,0,350,16,54,.296,0,2,.000,16,52,.308,.296,12,23,.522,26,34,60,14,6,6,17,58,44
218,Charles Jenkins\jenkich01,SG-PG,23,TOT,59,1,441,49,121,.405,1,2,.500,48,119,.403,.409,12,22,.545,8,24,32,44,15,2,21,22,111
218,Charles Jenkins\jenkich01,SG,23,GSW,47,0,291,35,83,.422,1,2,.500,34,81,.420,.428,10,18,.556,5,16,21,28,9,1,19,18,81
218,Charles Jenkins\jenkich01,PG,23,PHI,12,1,150,14,38,.368,0,0,,14,38,.368,.368,2,4,.500,3,8,11,16,6,1,2,4,30
219,John Jenkins\jenkijo01,SG,21,ATL,61,2,902,131,294,.446,53,138,.384,78,156,.500,.536,59,70,.843,17,77,94,56,12,10,40,37,374
220,Brandon Jennings\jennibr01,PG,23,MIL,80,80,2897,497,1247,.399,173,461,.375,324,786,.412,.468,230,281,.819,59,187,246,521,125,10,203,155,1397
221,Jonas Jerebko\jerebjo01,PF,25,DET,49,2,892,142,316,.449,25,83,.301,117,233,.502,.489,68,88,.773,68,117,185,43,38,8,42,90,377
222,Amir Johnson\johnsam01,PF,25,TOR,81,38,2325,336,606,.554,5,13,.385,331,593,.558,.559,136,187,.727,227,384,611,122,81,110,117,301,813
223,Chris Johnson\johnsch03,C,27,MIN,30,0,284,48,75,.640,0,0,,48,75,.640,.640,21,34,.618,20,40,60,8,7,28,13,49,117
224,Chris Johnson\johnsch04,SF,22,MEM,8,0,102,11,25,.440,6,18,.333,5,7,.714,.560,1,2,.500,5,6,11,2,4,0,3,5,29
225,Ivan Johnson\johnsiv01,PF,28,ATL,69,5,1035,185,356,.520,1,13,.077,184,343,.536,.521,81,131,.618,76,190,266,46,56,14,71,131,452
226,James Johnson\johnsja01,SF,25,SAC,54,11,878,117,283,.413,2,21,.095,115,262,.439,.417,40,67,.597,49,96,145,58,41,50,68,99,276
227,Joe Johnson\johnsjo02,SG,31,BRK,72,72,2642,445,1052,.423,148,395,.375,297,657,.452,.493,132,161,.820,53,165,218,253,49,14,123,99,1170
228,Orlando Johnson\johnsor01,SG,23,IND,51,0,619,72,180,.400,36,94,.383,36,86,.419,.500,23,32,.719,20,90,110,47,11,9,29,51,203
229,Wesley Johnson\johnswe01,SF,25,PHO,50,21,953,161,396,.407,50,155,.323,111,241,.461,.470,27,35,.771,21,102,123,34,22,18,48,56,399
230,Darius Johnson-Odom\johnsda03,SG,23,LAL,4,0,6,0,4,.000,0,1,.000,0,3,.000,.000,0,0,,1,3,4,1,0,0,0,0,0
231,Dahntay Jones\jonesda02,SF,32,TOT,78,19,1016,82,222,.369,11,49,.224,71,173,.410,.394,87,113,.770,24,77,101,48,22,6,38,119,262
231,Dahntay Jones\jonesda02,SF,32,DAL,50,15,635,50,140,.357,8,37,.216,42,103,.408,.386,66,82,.805,13,57,70,28,10,5,22,73,174
231,Dahntay Jones\jonesda02,SF,32,ATL,28,4,381,32,82,.390,3,12,.250,29,70,.414,.409,21,31,.677,11,20,31,20,12,1,16,46,88
232,DeQuan Jones\jonesde01,SF,22,ORL,63,17,803,95,218,.436,9,35,.257,86,183,.470,.456,34,51,.667,17,88,105,16,19,22,30,55,233
233,Dominique Jones\jonesdo02,PG,24,DAL,29,3,338,40,109,.367,1,9,.111,39,100,.390,.372,35,53,.660,18,27,45,83,14,2,38,29,116
234,James Jones\jonesja02,SF,32,MIA,38,0,221,21,61,.344,16,53,.302,5,8,.625,.475,2,4,.500,0,22,22,13,2,6,3,16,60
235,Kevin Jones\joneske01,PF,23,CLE,32,0,334,43,107,.402,0,0,,43,107,.402,.402,9,15,.600,38,40,78,10,9,5,8,25,95
236,Perry Jones\jonespe01,SF,21,OKC,38,1,280,39,99,.394,0,2,.000,39,97,.402,.394,10,15,.667,12,50,62,10,5,6,15,23,88
237,Solomon Jones\jonesso01,PF,28,NYK,2,1,26,0,1,.000,0,0,,0,1,.000,.000,0,0,,1,2,3,0,0,1,3,3,0
238,Terrence Jones\joneste01,PF,21,HOU,19,0,276,43,94,.457,5,19,.263,38,75,.507,.484,13,17,.765,28,37,65,15,12,19,13,21,104
239,DeAndre Jordan\jordade01,C,24,LAC,82,82,2010,314,488,.643,0,0,,314,488,.643,.643,96,249,.386,210,384,594,28,48,112,100,192,724
240,Cory Joseph\josepco01,PG,21,SAS,28,9,388,51,110,.464,6,21,.286,45,89,.506,.491,18,21,.857,12,40,52,53,15,4,21,25,126
241,Kris Joseph\josepkr01,SF,24,TOT,10,0,54,2,14,.143,0,3,.000,2,11,.182,.143,5,8,.625,1,6,7,1,3,0,2,3,9
241,Kris Joseph\josepkr01,SF,24,BOS,6,0,24,2,11,.182,0,2,.000,2,9,.222,.182,3,4,.750,1,4,5,1,0,0,2,2,7
241,Kris Joseph\josepkr01,SF,24,BRK,4,0,30,0,3,.000,0,1,.000,0,2,.000,.000,2,4,.500,0,2,2,0,3,0,0,1,2
242,Chris Kaman\kamanch01,C,30,DAL,66,52,1363,313,617,.507,0,1,.000,313,616,.508,.507,67,85,.788,97,275,372,51,29,52,103,141,693
243,Enes Kanter\kanteen01,C,20,UTA,70,2,1078,206,379,.544,1,1,1.000,205,378,.542,.545,93,117,.795,135,169,304,31,28,32,101,116,506
244,Jason Kidd*\kiddja01,SG,39,NYK,76,48,2043,152,409,.372,114,325,.351,38,84,.452,.511,40,48,.833,50,273,323,249,125,25,76,125,458
245,Michael Kidd-Gilchrist\kiddgmi01,SF,19,CHA,78,77,2025,281,613,.458,2,9,.222,279,604,.462,.460,140,187,.749,131,324,455,117,54,70,101,164,704
246,Andrei Kirilenko\kirilan01,SF,31,MIN,64,64,2034,284,560,.507,35,120,.292,249,440,.566,.538,188,250,.752,102,260,362,177,96,62,119,82,791
247,Linas Kleiza\kleizli01,SF,28,TOR,20,3,376,48,144,.333,20,66,.303,28,78,.359,.403,32,38,.842,10,42,52,16,4,2,14,45,148
248,Brandon Knight\knighbr03,PG,21,DET,75,75,2365,357,878,.407,120,327,.367,237,551,.430,.475,165,225,.733,54,193,247,303,58,8,205,157,999
249,Kyle Korver\korveky01,SF,31,ATL,74,60,2259,277,601,.461,189,414,.457,88,187,.471,.618,67,78,.859,23,270,293,146,70,37,70,170,810
250,Kosta Koufos\koufoko01,C,23,DEN,81,81,1817,295,508,.581,0,1,.000,295,507,.582,.581,58,104,.558,211,351,562,32,44,103,53,246,648
251,Viacheslav Kravtsov\kravtvi01,C,25,DET,25,0,224,33,46,.717,0,0,,33,46,.717,.717,11,37,.297,24,21,45,9,5,9,14,32,77
252,Doron Lamb\lambdo01,SG,21,TOT,47,0,577,60,163,.368,14,37,.378,46,126,.365,.411,20,34,.588,8,38,46,32,13,0,26,52,154
252,Doron Lamb\lambdo01,SG,21,MIL,23,0,280,33,95,.347,4,16,.250,29,79,.367,.368,8,15,.533,3,14,17,20,7,0,16,27,78
252,Doron Lamb\lambdo01,SG,21,ORL,24,0,297,27,68,.397,10,21,.476,17,47,.362,.471,12,19,.632,5,24,29,12,6,0,10,25,76
253,Jeremy Lamb\lambje01,SF,20,OKC,23,0,147,24,68,.353,9,30,.300,15,38,.395,.419,14,14,1.000,5,13,18,5,2,2,6,13,71
254,Carl Landry\landrca01,PF,29,GSW,81,2,1876,325,602,.540,1,3,.333,324,599,.541,.541,223,273,.817,180,303,483,65,35,31,115,190,874
255,Ty Lawson\lawsoty01,PG,25,DEN,73,71,2513,448,971,.461,85,232,.366,363,739,.491,.505,235,311,.756,36,162,198,501,107,8,182,135,1216
256,Courtney Lee\leeco01,SG,27,BOS,78,39,1941,246,530,.464,58,156,.372,188,374,.503,.519,62,72,.861,31,159,190,143,89,21,84,139,612
257,David Lee\leeda02,PF,29,GSW,79,79,2907,602,1160,.519,0,4,.000,602,1156,.521,.519,255,320,.797,218,668,886,279,67,22,207,246,1459
258,Malcolm Lee\leema01,SG,22,MIN,16,12,289,29,76,.382,8,24,.333,21,52,.404,.434,12,20,.600,15,24,39,20,12,6,10,30,78
259,Kawhi Leonard\leonaka01,SF,21,SAS,58,57,1810,260,526,.494,65,174,.374,195,352,.554,.556,104,126,.825,63,283,346,93,97,32,62,99,689
260,Meyers Leonard\leoname01,C,20,POR,69,9,1206,151,277,.545,3,7,.429,148,270,.548,.551,72,89,.809,80,175,255,33,11,38,49,168,377
261,Jon Leuer\leuerjo01,PF-C,23,TOT,28,0,187,25,52,.481,0,3,.000,25,49,.510,.481,6,13,.462,13,24,37,8,6,0,8,21,56
261,Jon Leuer\leuerjo01,C,23,CLE,9,0,91,10,28,.357,0,3,.000,10,25,.400,.357,2,6,.333,5,8,13,5,2,0,5,11,22
261,Jon Leuer\leuerjo01,PF,23,MEM,19,0,96,15,24,.625,0,0,,15,24,.625,.625,4,7,.571,8,16,24,3,4,0,3,10,34
262,Rashard Lewis\lewisra02,PF,33,MIA,55,9,792,103,249,.414,51,131,.389,52,118,.441,.516,28,45,.622,19,102,121,30,21,14,33,67,285
263,DeAndre Liggins\liggide01,SG,24,OKC,39,1,290,21,47,.447,7,19,.368,14,28,.500,.521,9,18,.500,13,40,53,15,18,3,14,33,58
264,Damian Lillard\lillada01,PG,22,POR,82,82,3167,553,1288,.429,185,503,.368,368,785,.469,.501,271,321,.844,42,215,257,531,74,19,243,172,1562
265,Jeremy Lin\linje01,PG,24,HOU,82,82,2640,396,897,.441,87,257,.339,309,640,.483,.490,216,275,.785,32,215,247,497,134,29,236,205,1095
266,Shaun Livingston\livinsh01,PG,27,TOT,66,16,1455,166,346,.480,0,4,.000,166,342,.485,.480,85,98,.867,31,127,158,215,48,31,76,127,417
266,Shaun Livingston\livinsh01,PG,27,WAS,17,4,320,24,66,.364,0,3,.000,24,63,.381,.364,15,15,1.000,2,35,37,38,11,2,17,22,63
266,Shaun Livingston\livinsh01,PG,27,CLE,49,12,1135,142,280,.507,0,1,.000,142,279,.509,.507,70,83,.843,29,92,121,177,37,29,59,105,354
267,Brook Lopez\lopezbr01,C,24,BRK,74,74,2253,570,1094,.521,0,1,.000,570,1093,.522,.521,297,392,.758,208,304,512,70,33,154,131,152,1437
268,Robin Lopez\lopezro01,C,24,NOH,82,82,2136,384,719,.534,0,0,,384,719,.534,.534,161,207,.778,226,236,462,64,32,128,110,167,929
269,Kevin Love\loveke01,PF,24,MIN,18,18,618,105,298,.352,20,92,.217,85,206,.413,.386,100,142,.704,64,188,252,42,13,9,39,34,330
270,Kyle Lowry\lowryky01,PG,26,TOR,68,52,2020,250,623,.401,101,279,.362,149,344,.433,.482,190,239,.795,56,265,321,435,94,24,157,218,791
271,John Lucas III\lucasjo02,PG,30,TOR,63,0,827,129,334,.386,57,151,.377,72,183,.393,.472,18,25,.720,8,57,65,105,23,1,26,50,333
272,Scott Machado\machasc01,PG,22,HOU,6,0,21,3,6,.500,0,1,.000,3,5,.600,.500,2,2,1.000,0,1,1,6,2,0,8,0,8
273,Shelvin Mack\macksh01,PG-SG,22,TOT,31,3,416,58,126,.460,18,49,.367,40,77,.519,.532,9,16,.563,3,37,40,68,15,0,34,39,143
273,Shelvin Mack\macksh01,PG,22,WAS,7,2,141,16,40,.400,4,13,.308,12,27,.444,.450,1,2,.500,3,13,16,23,6,0,8,10,37
273,Shelvin Mack\macksh01,SG,22,PHI,4,0,7,1,2,.500,0,1,.000,1,1,1.000,.500,0,0,,0,0,0,1,0,0,2,1,2
273,Shelvin Mack\macksh01,PG,22,ATL,20,1,268,41,84,.488,14,35,.400,27,49,.551,.571,8,14,.571,0,24,24,44,9,0,24,28,104
274,Corey Maggette\maggeco01,SF,33,DET,18,0,257,27,76,.355,5,21,.238,22,55,.400,.388,36,48,.750,5,20,25,19,6,2,17,42,95
275,Ian Mahinmi\mahinia01,C,26,IND,80,2,1322,149,329,.453,0,2,.000,149,327,.456,.453,104,171,.608,115,196,311,27,39,66,92,201,402
276,Shawn Marion\mariosh01,PF,34,DAL,67,67,2010,355,690,.514,23,73,.315,332,617,.538,.531,79,101,.782,146,379,525,163,75,47,103,111,812
277,Kendall Marshall\marshke01,PG,21,PHO,48,3,702,56,151,.371,23,73,.315,33,78,.423,.447,8,14,.571,4,38,42,143,22,4,57,48,143
278,Cartier Martin\martica01,SF,28,WAS,41,3,694,96,252,.381,58,146,.397,38,106,.358,.496,20,28,.714,11,89,100,20,19,6,32,58,270
279,Kenyon Martin\martike01,C,35,NYK,18,11,431,56,93,.602,0,0,,56,93,.602,.602,17,40,.425,34,61,95,8,16,17,16,64,129
280,Kevin Martin\martike02,SG,29,OKC,77,0,2136,350,778,.450,158,371,.426,192,407,.472,.551,219,246,.890,31,147,178,106,72,8,101,138,1077
281,Roger Mason\masonro01,SG,32,NOH,69,13,1219,132,305,.433,66,159,.415,66,146,.452,.541,39,43,.907,11,121,132,74,26,11,51,104,369
282,Wesley Matthews\matthwe02,SG,26,POR,69,69,2403,352,808,.436,169,425,.398,183,383,.478,.540,149,187,.797,35,156,191,174,90,18,109,172,1022
283,Jason Maxiell\maxieja01,PF,29,DET,72,71,1789,204,457,.446,0,0,,204,457,.446,.446,90,145,.621,135,274,409,54,32,95,81,172,498
284,Eric Maynor\maynoer01,PG-SG,25,TOT,64,0,963,106,281,.377,34,96,.354,72,185,.389,.438,45,62,.726,9,37,46,182,22,1,79,55,291
284,Eric Maynor\maynoer01,PG,25,OKC,37,0,391,36,115,.313,15,46,.326,21,69,.304,.378,17,21,.810,5,13,18,73,10,0,31,19,104
284,Eric Maynor\maynoer01,SG,25,POR,27,0,572,70,166,.422,19,50,.380,51,116,.440,.479,28,41,.683,4,24,28,109,12,1,48,36,187
285,O.J. Mayo\mayooj01,SG,25,DAL,82,82,2913,461,1026,.449,142,349,.407,319,677,.471,.519,191,233,.820,36,255,291,361,93,23,210,195,1255
286,Luc Mbah a Moute\mbahalu01,SF,26,MIL,58,45,1326,151,377,.401,13,37,.351,138,340,.406,.418,72,126,.571,89,167,256,55,42,14,70,82,387
287,JaVale McGee\mcgeeja01,C,25,DEN,79,0,1433,303,527,.575,1,1,1.000,302,526,.574,.576,110,186,.591,158,223,381,24,30,157,90,184,717
288,Dominic McGuire\mcguido01,SF,27,TOT,26,10,387,24,56,.429,0,0,,24,56,.429,.429,3,10,.300,19,59,78,20,13,11,12,39,51
288,Dominic McGuire\mcguido01,SF,27,TOR,15,9,230,15,32,.469,0,0,,15,32,.469,.469,2,6,.333,11,37,48,10,5,8,7,26,32
288,Dominic McGuire\mcguido01,SF,27,NOH,9,0,145,9,21,.429,0,0,,9,21,.429,.429,1,2,.500,7,21,28,9,8,3,5,13,19
288,Dominic McGuire\mcguido01,SF,27,IND,2,1,12,0,3,.000,0,0,,0,3,.000,.000,0,2,.000,1,1,2,1,0,0,0,0,0
289,Josh McRoberts\mcrobjo01,PF,25,TOT,67,22,1487,156,343,.455,24,84,.286,132,259,.510,.490,65,85,.765,93,232,325,141,32,27,66,131,401
289,Josh McRoberts\mcrobjo01,PF,25,ORL,41,3,685,60,153,.392,17,55,.309,43,98,.439,.448,22,30,.733,41,96,137,70,10,12,28,65,159
289,Josh McRoberts\mcrobjo01,PF,25,CHA,26,19,802,96,190,.505,7,29,.241,89,161,.553,.524,43,55,.782,52,136,188,71,22,15,38,66,242
290,Jodie Meeks\meeksjo01,SG,25,LAL,78,10,1663,205,530,.387,122,342,.357,83,188,.441,.502,86,96,.896,37,134,171,69,58,5,52,103,618
291,Fab Melo\melofa01,C,22,BOS,6,0,36,3,6,.500,0,0,,3,6,.500,.500,1,4,.250,0,3,3,0,2,2,1,7,7
292,Khris Middleton\middlkh01,SG,21,DET,27,0,475,62,141,.440,14,45,.311,48,96,.500,.489,27,32,.844,4,46,50,28,15,4,11,53,165
293,C.J. Miles\milescj01,SF,25,CLE,65,13,1364,255,614,.415,126,328,.384,129,286,.451,.518,93,107,.869,24,150,174,63,49,17,69,138,729
294,Darko Milicic\milicda01,C,27,BOS,1,0,5,0,1,.000,0,0,,0,1,.000,.000,0,0,,0,1,1,0,0,0,2,1,0
295,Andre Miller\millean02,PG,36,DEN,82,11,2151,303,632,.479,17,64,.266,286,568,.504,.493,163,194,.840,60,178,238,484,73,11,172,159,786
296,Darius Miller\milleda01,SF,22,NOH,52,2,694,44,108,.407,22,56,.393,22,52,.423,.509,8,8,1.000,8,70,78,44,17,12,23,89,118
297,Mike Miller\millemi01,SF,32,MIA,59,17,900,100,231,.433,73,175,.417,27,56,.482,.591,8,11,.727,18,139,157,99,21,4,35,63,281
298,Quincy Miller\millequ01,PF,20,DEN,7,0,26,4,12,.333,0,1,.000,4,11,.364,.333,1,2,.500,1,1,2,3,1,0,1,3,9
299,Patty Mills\millspa02,PG,24,SAS,58,2,656,113,241,.469,52,130,.400,61,111,.550,.577,16,19,.842,9,41,50,62,26,4,39,55,294
300,Paul Millsap\millspa01,PF,27,UTA,78,78,2375,429,875,.490,13,39,.333,416,836,.498,.498,264,356,.742,177,377,554,201,102,80,138,232,1135
301,Nazr Mohammed\mohamna01,C,35,CHI,63,12,693,66,180,.367,0,2,.000,66,178,.371,.367,34,47,.723,73,122,195,26,21,32,24,97,166
302,Greg Monroe\monrogr01,C,22,DET,81,81,2687,514,1058,.486,0,4,.000,514,1054,.488,.486,270,392,.689,236,541,777,281,105,55,234,190,1298
303,E'Twaun Moore\mooreet01,SG,23,ORL,75,21,1682,237,598,.396,67,197,.340,170,401,.424,.452,47,59,.797,48,119,167,206,51,23,105,122,588
304,Darius Morris\morrida01,PG,22,LAL,48,17,683,73,188,.388,24,66,.364,49,122,.402,.452,24,37,.649,24,33,57,76,21,2,45,58,194
305,Marcus Morris\morrima03,PF-SF,23,TOT,77,23,1524,222,526,.422,86,233,.369,136,293,.464,.504,66,117,.564,80,197,277,62,45,20,77,160,596
305,Marcus Morris\morrima03,PF,23,HOU,54,17,1154,171,400,.428,74,194,.381,97,206,.471,.520,49,75,.653,63,156,219,47,27,16,53,120,465
305,Marcus Morris\morrima03,SF,23,PHO,23,6,370,51,126,.405,12,39,.308,39,87,.448,.452,17,42,.405,17,41,58,15,18,4,24,40,131
306,Markieff Morris\morrima02,PF,23,PHO,82,32,1837,266,653,.407,45,134,.336,221,519,.426,.442,93,127,.732,131,265,396,108,77,64,104,209,670
307,Anthony Morrow\morroan01,SG,27,TOT,41,1,383,64,145,.441,16,43,.372,48,102,.471,.497,20,22,.909,11,19,30,13,13,1,8,43,164
307,Anthony Morrow\morroan01,SG,27,ATL,24,1,301,47,111,.423,15,38,.395,32,73,.438,.491,16,18,.889,10,16,26,9,12,1,4,33,125
307,Anthony Morrow\morroan01,SG,27,DAL,17,0,82,17,34,.500,1,5,.200,16,29,.552,.515,4,4,1.000,1,3,4,4,1,0,4,10,39
308,Donatas Motiejunas\motiedo01,PF,22,HOU,44,14,538,97,213,.455,24,83,.289,73,130,.562,.512,32,51,.627,36,57,93,31,7,10,37,73,250
309,Arnett Moultrie\moultar01,PF,22,PHI,47,0,542,78,134,.582,0,0,,78,134,.582,.582,18,28,.643,76,69,145,10,17,10,19,43,174
310,Timofey Mozgov\mozgoti01,C,26,DEN,41,1,366,44,87,.506,0,2,.000,44,85,.518,.506,20,26,.769,50,57,107,9,6,18,25,57,108
311,Byron Mullens\mulleby01,PF,23,CHA,53,41,1428,217,563,.385,66,208,.317,151,355,.425,.444,64,99,.646,71,266,337,81,34,32,74,110,564
312,Kevin Murphy\murphke01,SG,22,UTA,17,0,52,7,28,.250,1,5,.200,6,23,.261,.268,0,0,,0,4,4,2,1,0,3,4,15
313,Troy Murphy\murphtr01,PF,32,DAL,14,1,256,22,61,.361,11,35,.314,11,26,.423,.451,10,11,.909,7,42,49,7,10,6,7,29,65
314,Steve Nash*\nashst01,PG,38,LAL,50,50,1627,236,475,.497,57,130,.438,179,345,.519,.557,107,116,.922,26,116,142,333,30,5,126,70,636
315,Gary Neal\nealga01,SG,28,SAS,68,17,1484,246,597,.412,89,251,.355,157,346,.454,.487,64,74,.865,13,130,143,129,30,2,69,93,645
316,Jameer Nelson\nelsoja01,PG,30,ORL,56,56,1977,306,780,.392,121,355,.341,185,425,.435,.470,89,102,.873,23,186,209,413,71,6,154,161,822
317,Andrew Nicholson\nichoan01,PF,23,ORL,75,28,1249,256,486,.527,0,0,,256,486,.527,.527,75,94,.798,69,189,258,44,24,32,79,133,587
318,Joakim Noah\noahjo01,C,27,CHI,66,64,2426,303,630,.481,0,5,.000,303,625,.485,.481,178,237,.751,260,473,733,262,78,141,176,185,784
319,Steve Novak\novakst01,SF,29,NYK,81,1,1641,178,430,.414,149,351,.425,29,79,.367,.587,30,33,.909,17,135,152,35,28,8,12,97,535
320,Dirk Nowitzki\nowitdi01,PF,34,DAL,53,47,1661,343,728,.471,65,157,.414,278,571,.487,.516,166,193,.860,37,326,363,132,38,37,70,93,917
321,Jermaine O'Neal\onealje01,C,34,PHO,55,4,1029,179,371,.482,0,0,,179,371,.482,.482,96,115,.835,82,211,293,42,19,78,73,126,454
322,Kyle O'Quinn\oquinky01,C,22,ORL,57,5,638,101,197,.513,0,1,.000,101,196,.515,.513,30,45,.667,65,144,209,52,11,26,37,107,232
323,Lamar Odom\odomla01,PF,33,LAC,82,2,1616,146,366,.399,18,90,.200,128,276,.464,.423,20,42,.476,117,363,480,142,69,58,86,214,330
324,Tim Ohlbrecht\ohlbrti01,C,24,HOU,3,0,12,1,3,.333,0,0,,1,3,.333,.333,1,1,1.000,0,1,1,1,1,0,4,1,3
325,Emeka Okafor\okafoem01,C,30,WAS,79,77,2052,328,687,.477,0,0,,328,687,.477,.477,109,191,.571,199,493,692,93,45,77,107,145,765
326,Daniel Orton\ortonda01,C,22,OKC,13,0,104,12,26,.462,0,0,,12,26,.462,.462,9,17,.529,13,13,26,4,4,3,4,13,33
327,Travis Outlaw\outlatr01,SF,28,SAC,38,2,444,74,177,.418,14,50,.280,60,127,.472,.458,38,52,.731,17,44,61,21,11,8,19,35,200
328,Zaza Pachulia\pachuza01,C,28,ATL,52,15,1134,114,241,.473,0,3,.000,114,238,.479,.473,78,103,.757,132,204,336,79,35,12,70,128,306
329,Jannero Pargo\pargoja01,PG,33,TOT,32,0,507,78,212,.368,39,116,.336,39,96,.406,.460,12,13,.923,10,25,35,67,18,3,41,42,207
329,Jannero Pargo\pargoja01,PG,33,WAS,7,0,102,8,32,.250,3,20,.150,5,12,.417,.297,2,2,1.000,0,6,6,14,0,1,8,8,21
329,Jannero Pargo\pargoja01,PG,33,ATL,7,0,113,13,38,.342,7,20,.350,6,18,.333,.434,2,2,1.000,1,6,7,19,3,0,5,8,35
329,Jannero Pargo\pargoja01,PG,33,CHA,18,0,292,57,142,.401,29,76,.382,28,66,.424,.504,8,9,.889,9,13,22,34,15,2,28,26,151
330,Jeremy Pargo\pargoje01,PG-SG,26,TOT,39,11,655,99,250,.396,25,74,.338,74,176,.420,.446,42,62,.677,8,41,49,92,13,2,50,46,265
330,Jeremy Pargo\pargoje01,PG,26,CLE,25,11,447,75,187,.401,18,57,.316,57,130,.438,.449,28,41,.683,7,25,32,64,12,2,37,32,196
330,Jeremy Pargo\pargoje01,SG,26,PHI,14,0,208,24,63,.381,7,17,.412,17,46,.370,.437,14,21,.667,1,16,17,28,1,0,13,14,69
331,Tony Parker\parketo01,PG,30,SAS,66,66,2174,519,995,.522,24,68,.353,495,927,.534,.534,279,330,.845,18,180,198,499,54,6,170,92,1341
332,Chandler Parsons\parsoch01,SF,24,HOU,76,76,2758,456,939,.486,152,395,.385,304,544,.559,.567,113,155,.729,79,325,404,269,75,32,147,148,1177
333,Patrick Patterson\pattepa01,PF,23,TOT,71,41,1775,319,623,.512,51,132,.386,268,491,.546,.553,48,63,.762,113,224,337,81,31,40,61,138,737
333,Patrick Patterson\pattepa01,PF,23,HOU,47,38,1219,236,455,.519,35,96,.365,201,359,.560,.557,37,49,.755,73,148,221,51,18,27,42,90,544
333,Patrick Patterson\pattepa01,PF,23,SAC,24,3,556,83,168,.494,16,36,.444,67,132,.508,.542,11,14,.786,40,76,116,30,13,13,19,48,193
334,Chris Paul\paulch01,PG,27,LAC,70,70,2335,412,856,.481,76,232,.328,336,624,.538,.526,286,323,.885,53,209,262,678,169,10,159,143,1186
335,Sasha Pavlovic\pavloal01,SG,29,POR,39,1,528,42,119,.353,18,60,.300,24,59,.407,.429,1,6,.167,7,49,56,32,24,5,14,59,103
336,Nikola Pekovic\pekovni01,C,27,MIN,62,62,1959,385,741,.520,0,0,,385,741,.520,.520,241,324,.744,230,315,545,53,43,50,101,143,1011
337,Kendrick Perkins\perkike01,C,28,OKC,78,78,1954,143,313,.457,0,1,.000,143,312,.458,.457,44,72,.611,110,356,466,111,43,83,109,227,330
338,Johan Petro\petrojo01,C,27,ATL,31,8,352,48,110,.436,1,4,.250,47,106,.443,.441,11,12,.917,33,79,112,16,10,9,24,48,108
339,Paul Pierce\piercpa01,SF,35,BOS,77,77,2575,476,1092,.436,145,382,.380,331,710,.466,.502,333,423,.787,45,442,487,370,84,30,214,210,1430
340,Mickael Pietrus\pietrmi01,SF,30,TOR,19,16,386,34,98,.347,20,64,.313,14,34,.412,.449,12,18,.667,5,31,36,9,12,6,16,33,100
341,Dexter Pittman\pittmde01,C,24,TOT,11,0,32,4,11,.364,0,0,,4,11,.364,.364,0,3,.000,7,5,12,0,0,0,3,8,8
341,Dexter Pittman\pittmde01,C,24,MIA,4,0,12,3,5,.600,0,0,,3,5,.600,.600,0,0,,4,3,7,0,0,0,2,4,6
341,Dexter Pittman\pittmde01,C,24,MEM,7,0,20,1,6,.167,0,0,,1,6,.167,.167,0,3,.000,3,2,5,0,0,0,1,4,2
342,Miles Plumlee\plumlmi01,C,24,IND,14,0,55,5,21,.238,0,0,,5,21,.238,.238,3,4,.750,12,10,22,2,0,3,3,5,13
343,Quincy Pondexter\pondequ01,SF,24,MEM,59,1,1243,128,299,.428,60,152,.395,68,147,.463,.528,59,75,.787,43,89,132,61,35,6,42,95,375
344,A.J. Price\priceaj01,PG,26,WAS,57,22,1278,161,413,.390,70,200,.350,91,213,.427,.475,49,62,.790,20,94,114,205,33,3,64,73,441
345,Ronnie Price\pricero01,PG,29,POR,39,0,510,39,120,.325,10,39,.256,29,81,.358,.367,17,24,.708,13,31,44,73,26,3,34,61,105
346,Pablo Prigioni\prigipa01,PG,35,NYK,78,18,1263,100,220,.455,53,134,.396,47,86,.547,.575,22,25,.880,41,102,143,236,69,2,86,127,275
347,Tayshaun Prince\princta01,SF,32,TOT,82,81,2631,359,820,.438,38,94,.404,321,726,.442,.461,96,130,.738,72,292,364,196,48,25,89,86,852
347,Tayshaun Prince\princta01,SF,32,DET,45,45,1457,215,484,.444,23,53,.434,192,431,.445,.468,74,93,.796,43,166,209,111,21,13,54,45,527
347,Tayshaun Prince\princta01,SF,32,MEM,37,36,1174,144,336,.429,15,41,.366,129,295,.437,.451,22,37,.595,29,126,155,85,27,12,35,41,325
348,Joel Przybilla\przybjo01,C,33,MIL,12,1,68,1,4,.250,0,0,,1,4,.250,.250,0,2,.000,5,16,21,4,1,2,4,10,2
349,Chris Quinn\quinnch01,SG,29,CLE,7,0,78,4,16,.250,0,5,.000,4,11,.364,.250,2,2,1.000,1,1,2,9,3,0,6,4,10
350,Vladimir Radmanovic\radmavl01,PF,32,CHI,25,0,144,13,43,.302,5,27,.185,8,16,.500,.360,2,3,.667,10,18,28,8,8,4,7,29,33
351,Anthony Randolph\randoan01,PF,23,DEN,39,0,329,56,114,.491,0,8,.000,56,106,.528,.491,31,45,.689,29,66,95,12,19,21,37,41,143
352,Shavlik Randolph\randosh01,PF,29,BOS,16,0,198,28,48,.583,0,0,,28,48,.583,.583,11,27,.407,28,42,70,4,8,7,10,38,67
353,Zach Randolph\randoza01,PF,31,MEM,76,75,2607,471,1024,.460,2,23,.087,469,1001,.469,.461,225,300,.750,310,544,854,108,61,31,150,180,1169
354,J.J. Redick\redicjj01,SG,28,TOT,78,13,2379,382,880,.434,165,451,.366,217,429,.506,.528,171,190,.900,17,154,171,296,38,9,138,117,1100
354,J.J. Redick\redicjj01,SG,28,ORL,50,11,1575,262,582,.450,117,300,.390,145,282,.514,.551,115,129,.891,9,110,119,220,29,5,105,70,756
354,J.J. Redick\redicjj01,SG,28,MIL,28,2,804,120,298,.403,48,151,.318,72,147,.490,.483,56,61,.918,8,44,52,76,9,4,33,47,344
355,Jason Richardson\richaja01,SG,32,PHI,33,33,936,135,336,.402,57,167,.341,78,169,.462,.487,20,33,.606,19,108,127,51,40,15,26,57,347
356,Quentin Richardson\richaqu01,SF,32,NYK,1,0,29,1,11,.091,1,4,.250,0,7,.000,.136,2,2,1.000,5,5,10,1,0,0,2,1,5
357,Luke Ridnour\ridnolu01,SG,31,MIN,82,82,2474,367,811,.453,66,212,.311,301,599,.503,.493,139,164,.848,41,165,206,311,82,15,130,187,939
358,Austin Rivers\riverau01,SG,20,NOH,61,26,1418,145,390,.372,28,86,.326,117,304,.385,.408,59,108,.546,16,93,109,127,26,9,74,122,377
359,Brian Roberts\roberbr01,PG,27,NOH,78,5,1324,213,511,.417,59,153,.386,154,358,.430,.475,70,77,.909,17,80,97,219,37,3,71,108,555
360,Nate Robinson\robinna01,PG,28,CHI,82,23,2086,399,921,.433,141,348,.405,258,573,.450,.510,135,169,.799,29,155,184,358,85,10,144,207,1074
361,Thomas Robinson\robinth01,PF,21,TOT,70,0,1056,138,321,.430,0,1,.000,138,320,.431,.430,57,109,.523,122,193,315,46,41,26,88,124,333
361,Thomas Robinson\robinth01,PF,21,SAC,51,0,809,103,243,.424,0,0,,103,243,.424,.424,41,71,.577,92,146,238,36,25,21,65,95,247
361,Thomas Robinson\robinth01,PF,21,HOU,19,0,247,35,78,.449,0,1,.000,35,77,.455,.449,16,38,.421,30,47,77,10,16,5,23,29,86
362,Rajon Rondo\rondora01,PG,26,BOS,38,38,1423,225,465,.484,12,50,.240,213,415,.513,.497,60,93,.645,43,169,212,420,70,9,148,96,522
363,Terrence Ross\rosste01,SG,21,TOR,73,2,1239,186,457,.407,65,196,.332,121,261,.464,.478,30,42,.714,35,109,144,53,43,14,48,122,467
364,Brandon Roy\roybr01,SG,28,MIN,5,5,122,11,35,.314,0,9,.000,11,26,.423,.314,7,10,.700,3,11,14,23,3,0,7,5,29
365,Ricky Rubio\rubiori01,PG,22,MIN,57,47,1691,185,514,.360,27,92,.293,158,422,.374,.386,211,264,.799,44,185,229,418,137,5,172,143,608
366,Brandon Rush\rushbr01,SF,27,GSW,2,0,25,6,9,.667,0,2,.000,6,7,.857,.667,2,3,.667,0,1,1,2,0,0,3,5,14
367,Robert Sacre\sacrero01,C,23,LAL,32,3,203,18,48,.375,0,0,,18,48,.375,.375,7,11,.636,9,25,34,6,0,10,10,38,43
368,John Salmons\salmojo01,SF,33,SAC,76,72,2278,244,612,.399,99,267,.371,145,345,.420,.480,85,110,.773,33,174,207,226,51,25,85,143,672
369,Samardo Samuels\samuesa01,C,24,CLE,18,1,196,22,60,.367,0,1,.000,22,59,.373,.367,14,24,.583,10,18,28,8,3,3,6,30,58
370,Larry Sanders\sandela01,C,24,MIL,71,55,1937,306,605,.506,0,2,.000,306,603,.507,.506,84,136,.618,224,448,672,83,53,201,87,233,696
371,Luis Scola\scolalu01,PF,32,PHO,82,67,2184,432,915,.472,3,16,.188,429,899,.477,.474,181,230,.787,158,383,541,182,67,35,126,257,1048
372,Mike Scott\scottmi01,PF,24,ATL,40,1,376,70,147,.476,0,1,.000,70,146,.479,.476,43,56,.768,39,71,110,12,4,2,21,32,183
373,Thabo Sefolosha\sefolth01,SG,28,OKC,81,81,2229,224,466,.481,108,258,.419,116,208,.558,.597,57,69,.826,58,259,317,125,103,44,64,177,613
374,Josh Selby\selbyjo01,PG,21,MEM,10,0,59,6,22,.273,1,6,.167,5,16,.313,.295,7,11,.636,0,5,5,4,2,0,7,7,20
375,Kevin Seraphin\serapke01,C,23,WAS,79,8,1721,330,716,.461,0,0,,330,716,.461,.461,61,88,.693,107,239,346,57,24,59,130,211,721
376,Ramon Sessions\sessira01,SG,26,CHA,61,0,1652,276,676,.408,33,107,.308,243,569,.427,.433,291,347,.839,27,142,169,230,48,7,104,91,876
377,Tornike Shengelia\shengto01,SF,21,BRK,19,0,93,10,23,.435,1,2,.500,9,21,.429,.457,9,16,.563,9,14,23,3,3,1,11,11,30
378,Iman Shumpert\shumpim01,SG,22,NYK,45,45,996,109,275,.396,51,127,.402,58,148,.392,.489,36,47,.766,31,105,136,75,43,7,37,99,305
379,Alexey Shved\shvedal01,SG,24,MIN,77,16,1840,236,635,.372,85,288,.295,151,347,.435,.439,108,150,.720,41,134,175,286,54,27,147,117,665
380,Henry Sims\simshe01,C,22,NOH,2,0,5,2,3,.667,0,0,,2,3,.667,.667,0,0,,2,0,2,0,0,0,1,1,4
381,Kyle Singler\singlky01,SF,24,DET,82,74,2293,275,642,.428,70,200,.350,205,442,.464,.483,100,124,.806,109,221,330,77,57,37,98,217,720
382,Chris Singleton\singlch01,PF,23,WAS,57,11,924,92,241,.382,7,36,.194,85,205,.415,.396,40,70,.571,51,133,184,37,38,24,45,124,231
383,Donald Sloan\sloando01,SG-PG,25,TOT,23,0,263,27,78,.346,7,19,.368,20,59,.339,.391,20,25,.800,3,25,28,38,5,0,14,17,81
383,Donald Sloan\sloando01,SG,25,CLE,20,0,257,27,78,.346,7,19,.368,20,59,.339,.391,20,25,.800,3,25,28,37,5,0,13,17,81
383,Donald Sloan\sloando01,PG,25,NOH,3,0,6,0,0,,0,0,,0,0,,,0,0,,0,0,0,1,0,0,1,0,0
384,Greg Smith\smithgr02,C,22,HOU,70,10,1110,170,274,.620,0,1,.000,170,273,.623,.620,81,130,.623,111,210,321,25,18,40,41,175,421
385,Ish Smith\smithis01,PG,24,TOT,52,3,516,56,159,.352,8,27,.296,48,132,.364,.377,3,7,.429,12,49,61,87,21,9,37,26,123
385,Ish Smith\smithis01,PG,24,ORL,36,3,378,39,116,.336,4,17,.235,35,99,.354,.353,3,7,.429,11,35,46,57,13,6,27,14,85
385,Ish Smith\smithis01,PG,24,MIL,16,0,138,17,43,.395,4,10,.400,13,33,.394,.442,0,0,,1,14,15,30,8,3,10,12,38
386,J.R. Smith\smithjr01,SG,27,NYK,80,0,2678,527,1249,.422,155,436,.356,372,813,.458,.484,237,311,.762,64,361,425,218,100,24,134,226,1446
387,Jason Smith\smithja02,C,26,NOH,51,0,876,167,341,.490,0,4,.000,167,337,.496,.490,86,102,.843,64,122,186,34,15,45,55,123,420
388,Josh Smith\smithjo03,PF,27,ATL,76,76,2683,550,1182,.465,61,201,.303,489,981,.498,.491,166,321,.517,133,506,639,321,94,136,226,175,1327
389,Nolan Smith\smithno01,PG,24,POR,40,0,288,42,114,.368,6,28,.214,36,86,.419,.395,20,28,.714,7,20,27,35,7,1,29,26,110
390,Marreese Speights\speigma01,C,25,TOT,79,3,1300,260,584,.445,3,10,.300,257,574,.448,.448,135,175,.771,146,240,386,47,24,53,80,175,658
390,Marreese Speights\speigma01,C,25,MEM,40,2,579,106,247,.429,2,5,.400,104,242,.430,.433,48,67,.716,76,113,189,18,10,27,35,86,262
390,Marreese Speights\speigma01,C,25,CLE,39,1,721,154,337,.457,1,5,.200,153,332,.461,.458,87,108,.806,70,127,197,29,14,26,45,89,396
391,Tiago Splitter\splitti01,PF,28,SAS,81,58,1997,315,563,.560,0,2,.000,315,561,.561,.560,208,285,.730,144,371,515,130,63,64,100,161,838
392,Jerry Stackhouse\stackje01,SF,38,BRK,37,0,544,66,172,.384,30,89,.337,36,83,.434,.471,20,23,.870,5,28,33,35,7,4,24,31,182
393,Lance Stephenson\stephla01,SG,22,IND,78,72,2278,275,598,.460,62,188,.330,213,410,.520,.512,75,115,.652,47,257,304,223,81,16,109,162,687
394,DeShawn Stevenson\stevede01,SG,31,ATL,56,31,1158,98,262,.374,76,209,.364,22,53,.415,.519,12,23,.522,18,104,122,52,29,6,23,69,284
395,Greg Stiemsma\stiemgr01,C,27,MIN,76,19,1209,127,278,.457,0,0,,127,278,.457,.457,53,69,.768,61,200,261,30,44,90,59,184,307
396,Julyan Stone\stoneju01,PG,24,DEN,4,0,28,2,2,1.000,0,0,,2,2,1.000,1.000,3,4,.750,2,1,3,2,1,0,2,4,7
397,Amar'e Stoudemire\stoudam01,PF,30,NYK,29,0,682,154,267,.577,0,0,,154,267,.577,.577,105,130,.808,60,85,145,13,10,21,50,89,413
398,Rodney Stuckey\stuckro01,SG,26,DET,76,24,2171,304,748,.406,55,182,.302,249,566,.440,.443,213,272,.783,43,169,212,270,51,17,134,127,876
399,Jared Sullinger\sullija01,PF,20,BOS,45,5,892,111,225,.493,1,5,.200,110,220,.500,.496,47,63,.746,92,172,264,35,22,22,29,154,270
400,DaJuan Summers\summeda01,PF,25,LAC,2,0,7,1,4,.250,0,0,,1,4,.250,.250,0,0,,0,2,2,1,0,0,0,0,2
401,Jeffery Taylor\tayloje03,SF,23,CHA,77,29,1507,172,399,.431,53,154,.344,119,245,.486,.497,75,103,.728,51,99,150,63,47,15,48,136,472
402,Tyshawn Taylor\tayloty01,PG,22,BRK,38,0,221,32,87,.368,6,13,.462,26,74,.351,.402,15,27,.556,2,16,18,21,13,0,25,25,85
403,Jeff Teague\teaguje01,PG,24,ATL,80,78,2628,439,974,.451,89,248,.359,350,726,.482,.496,199,226,.881,25,155,180,579,117,28,230,181,1166
404,Marquis Teague\teaguma01,PG,19,CHI,48,0,392,43,113,.381,4,23,.174,39,90,.433,.398,9,16,.563,3,41,44,63,9,7,35,47,99
405,Mirza Teletovic\teletmi01,PF,27,BRK,53,0,499,71,185,.384,37,108,.343,34,77,.442,.484,9,11,.818,33,62,95,23,13,8,20,53,188
406,Sebastian Telfair\telfase01,PG,27,TOT,59,2,980,112,309,.362,53,150,.353,59,159,.371,.448,54,69,.783,13,71,84,153,37,11,64,104,331
406,Sebastian Telfair\telfase01,PG,27,PHO,46,2,795,94,247,.381,43,113,.381,51,134,.381,.468,44,57,.772,12,56,68,114,28,10,53,84,275
406,Sebastian Telfair\telfase01,PG,27,TOR,13,0,185,18,62,.290,10,37,.270,8,25,.320,.371,10,12,.833,1,15,16,39,9,1,11,20,56
407,Garrett Temple\templga01,SG,26,WAS,51,36,1156,105,258,.407,26,80,.325,79,178,.444,.457,26,37,.703,29,94,123,115,50,17,61,94,262
408,Jason Terry\terryja01,SG,35,BOS,79,24,2124,281,648,.434,123,331,.372,158,317,.498,.529,114,131,.870,19,140,159,198,66,11,102,110,799
409,Hasheem Thabeet\thabeha01,C,25,OKC,66,4,770,64,106,.604,0,0,,64,106,.604,.604,32,53,.604,69,126,195,11,30,60,41,148,160
410,Isaiah Thomas\thomais02,PG,23,SAC,79,62,2122,366,832,.440,115,321,.358,251,511,.491,.509,253,287,.882,29,132,161,316,67,3,140,167,1100
411,Kurt Thomas\thomaku01,PF,40,NYK,39,17,392,45,83,.542,1,1,1.000,44,82,.537,.548,6,13,.462,24,65,89,21,10,16,8,52,97
412,Lance Thomas\thomala01,SF,24,NOH,59,9,646,53,106,.500,0,0,,53,106,.500,.500,43,59,.729,44,71,115,17,11,7,14,78,149
413,Malcolm Thomas\thomama01,PF,24,TOT,12,0,57,5,10,.500,0,0,,5,10,.500,.500,5,8,.625,5,11,16,4,2,2,3,8,15
413,Malcolm Thomas\thomama01,PF,24,GSW,5,0,21,0,1,.000,0,0,,0,1,.000,.000,3,4,.750,0,5,5,2,0,1,1,1,3
413,Malcolm Thomas\thomama01,PF,24,CHI,7,0,36,5,9,.556,0,0,,5,9,.556,.556,2,4,.500,5,6,11,2,2,1,2,7,12
414,Tyrus Thomas\thomaty01,PF,26,CHA,26,2,360,48,136,.353,3,8,.375,45,128,.352,.364,26,31,.839,16,44,60,19,14,15,17,51,125
415,Jason Thompson\thompja02,PF,26,SAC,82,81,2285,374,745,.502,0,3,.000,374,742,.504,.502,143,206,.694,172,377,549,84,48,61,101,227,891
416,Klay Thompson\thompkl01,SG,22,GSW,82,82,2936,508,1205,.422,211,526,.401,297,679,.437,.509,132,157,.841,32,274,306,183,86,45,157,237,1359
417,Tristan Thompson\thomptr01,PF,21,CLE,82,82,2564,390,799,.488,0,3,.000,390,796,.490,.488,177,291,.608,306,467,773,108,60,71,123,234,957
418,Marcus Thornton\thornma01,SG,25,SAC,72,8,1726,332,774,.429,141,379,.372,191,395,.484,.520,111,126,.881,50,131,181,91,61,4,68,105,916
419,Jamaal Tinsley\tinslja01,PG,34,UTA,66,32,1221,86,234,.368,39,127,.307,47,107,.439,.451,18,26,.692,17,98,115,290,64,14,106,106,229
420,Anthony Tolliver\tollian01,SF,27,ATL,62,11,963,82,216,.380,45,133,.338,37,83,.446,.484,44,51,.863,31,124,155,32,15,12,36,66,253
421,P.J. Tucker\tuckepj01,SG,27,PHO,79,45,1910,210,444,.473,22,70,.314,188,374,.503,.498,64,86,.744,132,218,350,109,62,19,67,145,506
422,Ronny Turiaf\turiaro01,C,30,LAC,65,0,701,49,97,.505,0,0,,49,97,.505,.505,23,63,.365,45,107,152,35,19,35,29,80,121
423,Hedo Turkoglu\turkohe01,SF,33,ORL,11,1,189,14,53,.264,1,24,.042,13,29,.448,.274,3,6,.500,4,22,26,23,7,1,12,11,32
424,Evan Turner\turneev01,SF,24,PHI,82,82,2892,441,1053,.419,58,159,.365,383,894,.428,.446,154,208,.740,56,461,517,354,71,17,187,197,1094
425,Jeremy Tyler\tylerje01,C,21,TOT,21,0,68,9,24,.375,0,0,,9,24,.375,.375,4,6,.667,6,14,20,1,1,2,6,10,22
425,Jeremy Tyler\tylerje01,C,21,GSW,20,0,63,9,24,.375,0,0,,9,24,.375,.375,4,6,.667,6,11,17,1,1,2,6,10,22
425,Jeremy Tyler\tylerje01,C,21,ATL,1,0,5,0,0,,0,0,,0,0,,,0,0,,0,3,3,0,0,0,0,0,0
426,Ekpe Udoh\udohek01,C,25,MIL,76,9,1312,117,269,.435,0,1,.000,117,268,.437,.435,89,119,.748,113,138,251,43,39,85,43,139,323
427,Beno Udrih\udrihbe01,SG-PG,30,TOT,66,9,1457,210,476,.441,34,102,.333,176,374,.471,.477,84,103,.816,34,107,141,302,41,3,108,90,538
427,Beno Udrih\udrihbe01,SG,30,MIL,39,0,719,113,238,.475,13,49,.265,100,189,.529,.502,24,33,.727,17,61,78,138,16,2,53,39,263
427,Beno Udrih\udrihbe01,PG,30,ORL,27,9,738,97,238,.408,21,53,.396,76,185,.411,.452,60,70,.857,17,46,63,164,25,1,55,51,275
428,Jonas Valanciunas\valanjo01,C,20,TOR,62,57,1482,204,366,.557,0,0,,204,366,.557,.557,146,185,.789,121,251,372,45,17,78,94,188,554
429,Anderson Varejao\varejan01,C,30,CLE,25,25,901,138,289,.478,0,5,.000,138,284,.486,.478,77,102,.755,138,223,361,84,37,14,44,68,353
430,Jarvis Varnado\varnaja01,PF,24,TOT,13,0,58,3,7,.429,0,0,,3,7,.429,.429,2,4,.500,2,7,9,3,1,2,6,10,8
430,Jarvis Varnado\varnaja01,PF,24,BOS,5,0,18,2,4,.500,0,0,,2,4,.500,.500,2,4,.500,1,2,3,1,1,0,1,1,6
430,Jarvis Varnado\varnaja01,PF,24,MIA,8,0,40,1,3,.333,0,0,,1,3,.333,.333,0,0,,1,5,6,2,0,2,5,9,2
431,Greivis Vasquez\vasqugr01,PG,26,NOH,78,78,2685,438,1012,.433,83,243,.342,355,769,.462,.474,124,154,.805,43,294,337,704,66,6,247,190,1083
432,Jan Vesely\veselja01,PF,22,WAS,51,4,601,57,114,.500,0,1,.000,57,113,.504,.500,12,39,.308,43,79,122,28,15,17,27,107,126
433,Charlie Villanueva\villach01,PF,28,DET,69,0,1092,175,464,.377,90,259,.347,85,205,.415,.474,27,49,.551,49,192,241,54,31,39,39,96,467
434,Nikola Vucevic\vucevni01,C,22,ORL,77,77,2559,461,889,.519,0,3,.000,461,886,.520,.519,86,126,.683,273,644,917,143,61,79,141,218,1008
435,Dwyane Wade\wadedw01,SG,31,MIA,69,69,2391,569,1093,.521,17,66,.258,552,1027,.537,.528,308,425,.725,86,258,344,352,128,56,194,140,1463
436,Dion Waiters\waitedi01,SG,21,CLE,61,48,1756,336,815,.412,63,203,.310,273,612,.446,.451,159,213,.746,22,127,149,183,59,16,121,113,894
437,Kemba Walker\walkeke02,PG,22,CHA,82,82,2859,526,1244,.423,107,332,.322,419,912,.459,.466,296,371,.798,60,223,283,471,160,31,200,153,1455
438,John Wall\walljo01,PG,22,WAS,49,42,1602,324,735,.441,12,45,.267,312,690,.452,.449,246,306,.804,35,161,196,373,65,37,157,117,906
439,Gerald Wallace\wallage01,SF,30,BRK,69,68,2076,182,458,.397,46,163,.282,136,295,.461,.448,121,190,.637,69,250,319,181,97,46,110,118,531
440,Rasheed Wallace\wallara01,C,38,NYK,21,0,296,55,142,.387,22,69,.319,33,73,.452,.465,14,20,.700,11,72,83,6,13,15,10,40,146
441,Luke Walton\waltolu01,PF,32,CLE,50,0,857,71,181,.392,20,67,.299,51,114,.447,.448,10,20,.500,38,107,145,166,42,13,60,98,172
442,Hakim Warrick\warriha01,PF,30,TOT,28,14,489,67,165,.406,0,3,.000,67,162,.414,.406,60,88,.682,21,68,89,25,13,6,29,37,194
442,Hakim Warrick\warriha01,PF,30,NOH,1,0,7,1,2,.500,0,0,,1,2,.500,.500,2,2,1.000,0,0,0,0,1,0,0,0,4
442,Hakim Warrick\warriha01,PF,30,CHA,27,14,482,66,163,.405,0,3,.000,66,160,.413,.405,58,86,.674,21,68,89,25,12,6,29,37,190
443,C.J. Watson\watsocj01,PG,28,BRK,80,8,1521,192,459,.418,88,214,.411,104,245,.424,.514,71,91,.780,38,107,145,161,66,12,69,123,543
444,Earl Watson\watsoea01,PG,33,UTA,48,4,829,37,120,.308,5,28,.179,32,92,.348,.329,17,25,.680,23,64,87,190,40,8,69,94,96
445,Maalik Wayns\waynsma01,PG,21,TOT,27,1,202,26,88,.295,7,31,.226,19,57,.333,.335,17,19,.895,1,6,7,27,6,0,15,26,76
445,Maalik Wayns\waynsma01,PG,21,PHI,21,1,165,19,72,.264,5,25,.200,14,47,.298,.299,13,15,.867,1,4,5,20,3,0,13,18,56
445,Maalik Wayns\waynsma01,PG,21,LAC,6,0,37,7,16,.438,2,6,.333,5,10,.500,.500,4,4,1.000,0,2,2,7,3,0,2,8,20
446,Martell Webster\webstma02,SF,26,WAS,76,62,2200,281,636,.442,139,329,.422,142,307,.463,.551,168,198,.848,53,241,294,143,49,17,90,166,869
447,David West\westda01,PF,32,IND,73,73,2435,502,1009,.498,4,19,.211,498,990,.503,.500,242,315,.768,145,418,563,213,74,69,157,149,1250
448,Russell Westbrook\westbru01,PG,24,OKC,82,82,2861,673,1535,.438,97,300,.323,576,1235,.466,.470,460,575,.800,111,317,428,607,145,24,273,189,1903
449,D.J. White\whitedj01,PF,26,BOS,12,0,86,12,23,.522,0,0,,12,23,.522,.522,5,9,.556,4,9,13,4,1,6,2,5,29
450,James White\whiteja02,SF,30,NYK,57,16,435,50,116,.431,14,41,.341,36,75,.480,.491,11,19,.579,5,43,48,29,13,4,17,44,125
451,Chris Wilcox\wilcoch01,C,30,BOS,61,7,830,110,153,.719,0,1,.000,110,152,.724,.719,39,58,.672,55,125,180,22,32,28,34,125,259
452,Damien Wilkins\wilkida02,SG,33,PHI,61,21,1095,145,316,.459,17,51,.333,128,265,.483,.486,81,109,.743,32,73,105,91,37,18,49,98,388
453,Deron Williams\willide01,PG,28,BRK,78,78,2842,495,1124,.440,169,447,.378,326,677,.482,.516,317,369,.859,29,203,232,604,75,30,218,194,1476
454,Derrick Williams\willide02,PF,21,MIN,78,56,1916,338,786,.430,65,196,.332,273,590,.463,.471,192,272,.706,96,334,430,46,44,37,101,127,933
455,Lou Williams\willilo02,SG,26,ATL,39,9,1119,187,443,.422,72,196,.367,115,247,.466,.503,105,121,.868,8,72,80,139,44,10,74,55,551
456,Marvin Williams\willima02,SF,26,UTA,73,51,1727,199,470,.423,54,166,.325,145,304,.477,.481,77,99,.778,55,208,263,77,37,38,60,98,529
457,Mo Williams\willima01,PG,30,UTA,46,46,1418,229,533,.430,59,154,.383,170,379,.449,.485,75,85,.882,24,86,110,285,46,9,125,105,592
458,Reggie Williams\willire02,SF,26,CHA,40,0,380,57,132,.432,22,72,.306,35,60,.583,.515,10,21,.476,8,43,51,39,12,1,19,19,146
459,Terrence Williams\willite01,SF,25,BOS,24,0,318,48,97,.495,5,15,.333,43,82,.524,.521,9,21,.429,4,40,44,38,11,2,22,13,110
460,Metta World Peace\artesro01,SF,33,LAL,75,66,2530,332,824,.403,141,412,.342,191,412,.464,.488,124,169,.734,101,271,372,112,122,42,98,198,929
461,Brandan Wright\wrighbr03,C,25,DAL,64,16,1149,241,404,.597,0,3,.000,241,401,.601,.597,59,96,.615,85,175,260,38,26,76,34,78,541
462,Chris Wright\wrighch02,SG,23,DAL,3,0,4,1,2,.500,0,0,,1,2,.500,.500,0,0,,0,0,0,0,0,0,1,0,2
463,Dorell Wright\wrighdo01,SF,27,PHI,79,8,1783,237,599,.396,135,361,.374,102,238,.429,.508,120,141,.851,42,260,302,150,62,35,64,98,729
464,Tony Wroten\wroteto01,SG,19,MEM,35,0,272,33,86,.384,4,16,.250,29,70,.414,.407,21,29,.724,13,15,28,43,8,4,29,34,91
465,Nick Young\youngni01,SG,27,PHI,59,17,1411,224,542,.413,75,210,.357,149,332,.449,.482,105,128,.820,24,106,130,84,36,14,50,84,628
466,Sam Young\youngsa01,SG,27,IND,56,3,693,58,148,.392,16,52,.308,42,96,.438,.446,23,43,.535,26,97,123,42,15,8,33,62,155
467,Thaddeus Young\youngth01,PF,24,PHI,76,76,2629,509,958,.531,1,8,.125,508,950,.535,.532,108,188,.574,182,389,571,125,133,55,90,191,1127
468,Luke Zeller\zellelu01,C,25,PHO,16,0,58,9,26,.346,1,5,.200,8,21,.381,.365,0,0,,1,9,10,3,0,0,0,5,19
469,Tyler Zeller\zellety01,C,23,CLE,77,55,2033,245,559,.438,0,4,.000,245,555,.441,.438,120,157,.764,159,279,438,96,35,70,95,251,610
