Rk,Player,Pos,Age,Tm,G,GS,MP,FG,FGA,FG%,3P,3PA,3P%,2P,2PA,2P%,eFG%,FT,FTA,FT%,ORB,DRB,TRB,AST,STL,BLK,TOV,PF,PTS
1,Quincy Acy\acyqu01,PF,25,SAC,59,29,876,119,214,.556,19,49,.388,100,165,.606,.600,50,68,.735,65,123,188,27,29,24,27,103,307
2,Jordan Adams\adamsjo01,SG,21,MEM,2,0,15,2,6,.333,0,1,.000,2,5,.400,.333,3,5,.600,0,2,2,3,3,0,2,2,7
3,Steven Adams\adamsst01,C,22,OKC,80,80,2014,261,426,.613,0,0,,261,426,.613,.613,114,196,.582,219,314,533,62,42,89,84,223,636
4,Arron Afflalo\afflaar01,SG,30,NYK,71,57,2371,354,799,.443,91,238,.382,263,561,.469,.500,110,131,.840,23,243,266,144,25,10,82,142,909
5,Alexis Ajinca\ajincal01,C,27,NOP,59,17,861,150,315,.476,0,1,.000,150,314,.478,.476,52,62,.839,75,194,269,31,19,36,54,134,352
6,Cole Aldrich\aldrico01,C,27,LAC,60,5,800,134,225,.596,0,0,,134,225,.596,.596,60,84,.714,86,202,288,50,47,68,64,139,328
7,LaMarcus Aldridge\aldrila01,PF,30,SAS,74,74,2261,536,1045,.513,0,16,.000,536,1029,.521,.513,259,302,.858,176,456,632,110,38,81,99,151,1331
8,Cliff Alexander\alexacl01,PF,20,POR,8,0,36,5,10,.500,0,0,,5,10,.500,.500,0,0,,2,4,6,0,1,2,1,1,10
9,Lavoy Allen\allenla01,PF,26,IND,79,28,1599,191,370,.516,0,0,,191,370,.516,.516,46,73,.630,162,262,424,76,26,42,69,147,428
10,Tony Allen\allento01,SG,34,MEM,64,57,1620,215,469,.458,15,42,.357,200,427,.468,.474,90,138,.652,104,192,296,70,110,18,78,175,535
11,Al-Farouq Aminu\aminual01,SF,25,POR,82,82,2341,299,719,.416,126,349,.361,173,370,.468,.503,115,156,.737,98,401,499,138,72,53,120,171,839
12,Lou Amundson\amundlo01,PF,33,NYK,29,0,204,19,53,.358,0,0,,19,53,.358,.358,14,27,.519,23,26,49,12,6,7,15,44,52
13,Chris Andersen\anderch01,C,37,TOT,27,15,402,38,72,.528,4,14,.286,34,58,.586,.556,25,36,.694,36,62,98,12,15,13,9,29,105
13,Chris Andersen\anderch01,C,37,MIA,7,1,36,4,10,.400,2,5,.400,2,5,.400,.500,3,4,.750,3,6,9,3,1,3,2,4,13
13,Chris Andersen\anderch01,C,37,MEM,20,14,366,34,62,.548,2,9,.222,32,53,.604,.565,22,32,.688,33,56,89,9,14,10,7,25,92
14,Alan Anderson\anderal01,SG,33,WAS,13,0,192,21,59,.356,12,37,.324,9,22,.409,.458,11,15,.733,1,26,27,14,4,1,2,25,65
15,James Anderson\anderja01,SG,26,SAC,51,15,721,67,178,.376,23,86,.267,44,92,.478,.441,22,29,.759,13,73,86,41,21,14,42,54,179
16,Justin Anderson\anderju01,SF,22,DAL,55,9,647,71,175,.406,22,83,.265,49,92,.533,.469,44,55,.800,18,114,132,29,19,25,24,45,208
17,Kyle Anderson\anderky01,SF,22,SAS,78,11,1245,138,295,.468,12,37,.324,126,258,.488,.488,62,83,.747,25,219,244,123,60,29,59,97,350
18,Ryan Anderson\anderry01,PF,27,NOP,66,7,2008,397,929,.427,131,358,.366,266,571,.466,.498,199,228,.873,131,265,396,73,38,25,90,109,1124
19,Giannis Antetokounmpo\antetgi01,PG,21,MIL,80,79,2823,513,1013,.506,28,109,.257,485,904,.537,.520,296,409,.724,113,499,612,345,94,113,208,258,1350
20,Thanasis Antetokounmpo\antetth01,SF,23,NYK,2,0,6,3,4,.750,0,1,.000,3,3,1.000,.750,0,0,,0,1,1,0,0,0,0,2,6
21,Carmelo Anthony\anthoca01,SF,31,NYK,72,72,2530,567,1307,.434,105,310,.339,462,997,.463,.474,334,403,.829,98,458,556,299,62,38,176,180,1573
22,Joel Anthony\anthojo01,C,33,DET,19,0,96,6,10,.600,0,0,,6,10,.600,.600,6,8,.750,8,13,21,1,2,12,2,15,18
23,Keith Appling\applike01,PG,23,ORL,5,0,27,2,8,.250,0,3,.000,2,5,.400,.250,2,2,1.000,0,1,1,1,1,0,3,5,6
24,Trevor Ariza\arizatr01,SF,30,HOU,81,81,2859,357,859,.416,185,499,.371,172,360,.478,.523,126,161,.783,67,299,366,188,160,26,113,177,1025
25,Darrell Arthur\arthuda01,PF,27,DEN,70,16,1516,221,489,.452,45,117,.385,176,372,.473,.498,40,53,.755,86,207,293,96,53,48,66,185,527
26,Omer Asik\asikom01,C,29,NOP,68,64,1178,104,195,.533,0,0,,104,195,.533,.533,61,112,.545,120,294,414,26,21,23,60,124,269
27,D.J. Augustin\augusdj01,PG,28,TOT,62,0,1178,148,350,.423,68,168,.405,80,182,.440,.520,103,128,.805,8,87,95,198,38,4,84,85,467
27,D.J. Augustin\augusdj01,PG,28,OKC,34,0,519,46,121,.380,24,61,.393,22,60,.367,.479,26,34,.765,5,38,43,66,13,2,30,41,142
27,D.J. Augustin\augusdj01,PG,28,DEN,28,0,659,102,229,.445,44,107,.411,58,122,.475,.541,77,94,.819,3,49,52,132,25,2,54,44,325
28,Jeff Ayres\pendeje02,C,28,LAC,17,0,107,12,23,.522,0,1,.000,12,22,.545,.522,6,6,1.000,4,18,22,5,0,3,6,18,30
29,Luke Babbitt\babbilu01,SF,26,NOP,47,13,845,122,289,.422,44,109,.404,78,180,.433,.498,39,50,.780,25,123,148,53,11,7,23,90,327
30,Cameron Bairstow\bairsca01,C,25,CHI,18,2,103,13,40,.325,1,5,.200,12,35,.343,.338,7,8,.875,4,24,28,6,2,3,4,19,34
31,Leandro Barbosa\barbole01,SG,33,GSW,68,0,1079,171,370,.462,39,110,.355,132,260,.508,.515,52,62,.839,28,89,117,82,44,10,53,107,433
32,J.J. Barea\bareajo01,PG,31,DAL,74,16,1667,317,711,.446,100,260,.385,217,451,.481,.516,74,96,.771,26,126,152,302,26,2,113,110,808
33,Andrea Bargnani\bargnan01,C,30,BRK,46,0,634,127,279,.455,3,16,.188,124,263,.471,.461,47,57,.825,28,69,97,18,4,9,26,61,304
34,Harrison Barnes\barneha02,SF,23,GSW,66,59,2042,295,633,.466,82,214,.383,213,419,.508,.531,102,134,.761,77,248,325,117,41,10,57,136,774
35,Matt Barnes\barnema02,SF,35,MEM,76,45,2190,264,693,.381,119,370,.322,145,323,.449,.467,111,138,.804,84,336,420,163,78,57,121,234,758
36,Will Barton\bartowi01,SG,25,DEN,82,1,2353,425,983,.432,112,325,.345,313,658,.476,.489,216,268,.806,59,417,476,203,71,39,139,147,1178
37,Brandon Bass\bassbr01,PF,30,LAL,66,0,1342,174,317,.549,0,2,.000,174,315,.552,.549,125,148,.845,104,181,285,74,33,55,42,125,473
38,Nicolas Batum\batumni01,SF,27,CHO,70,70,2448,372,873,.426,139,399,.348,233,474,.492,.506,163,192,.849,55,373,428,403,65,43,205,114,1046
39,Jerryd Bayless\bayleje01,SG,27,MIL,52,18,1505,185,437,.423,101,231,.437,84,206,.408,.539,70,90,.778,21,120,141,163,47,11,73,111,541
40,Aron Baynes\baynear01,C,29,DET,81,1,1233,194,384,.505,0,2,.000,194,382,.508,.505,126,165,.764,140,244,384,51,21,52,67,151,514
41,Kent Bazemore\bazemke01,SF,26,ATL,75,68,2083,320,725,.441,109,305,.357,211,420,.502,.517,123,151,.815,28,351,379,171,98,38,138,176,872
42,Bradley Beal\bealbr01,SG,22,WAS,55,35,1708,359,799,.449,105,271,.387,254,528,.481,.515,135,176,.767,41,147,188,162,54,11,112,117,958
43,Michael Beasley\beaslmi01,PF,27,HOU,20,0,363,107,205,.522,3,9,.333,104,196,.531,.529,38,49,.776,29,69,98,16,11,9,24,39,255
44,Marco Belinelli\belinma01,SG,29,SAC,68,7,1672,245,635,.386,91,297,.306,154,338,.456,.457,115,138,.833,10,107,117,127,37,2,80,91,696
45,Anthony Bennett\bennean01,PF,22,TOR,19,0,84,8,27,.296,3,14,.214,5,13,.385,.352,9,10,.900,6,17,23,0,5,0,4,8,28
46,Patrick Beverley\beverpa01,PG,27,HOU,71,63,2041,258,594,.434,124,310,.400,134,284,.472,.539,60,88,.682,73,177,250,239,94,26,91,234,700
47,Bismack Biyombo\biyombi01,C,23,TOR,82,22,1808,156,288,.542,0,1,.000,156,287,.544,.542,142,226,.628,182,473,655,29,19,133,71,225,454
48,Nemanja Bjelica\bjeline01,PF,27,MIN,60,0,1075,110,235,.468,48,125,.384,62,110,.564,.570,40,55,.727,49,161,210,83,26,21,47,154,308
49,Tarik Black\blackta01,C,24,LAL,39,0,496,57,104,.548,0,0,,57,104,.548,.548,19,45,.422,44,113,157,16,14,18,22,78,133
50,DeJuan Blair\blairde01,C,26,WAS,29,0,218,28,68,.412,0,1,.000,28,67,.418,.412,5,13,.385,20,37,57,11,8,2,15,53,61
51,Steve Blake\blakest01,PG,35,DET,58,2,986,93,240,.388,52,151,.344,41,89,.461,.496,16,20,.800,9,80,89,200,24,5,81,70,254
52,Eric Bledsoe\bledser01,PG,26,PHO,31,31,1059,223,492,.453,48,129,.372,175,363,.482,.502,138,172,.802,18,107,125,190,63,19,110,75,632
53,Bojan Bogdanovic\bogdabo02,SF,26,BRK,79,39,2115,324,749,.433,129,338,.382,195,411,.474,.519,110,132,.833,36,219,255,99,29,5,115,119,887
54,Andrew Bogut\bogutan01,C,31,GSW,70,66,1451,175,279,.627,1,1,1.000,174,278,.626,.629,24,50,.480,121,371,492,162,33,114,83,221,375
55,Matt Bonner\bonnema01,C,35,SAS,30,2,206,29,57,.509,15,34,.441,14,23,.609,.640,3,4,.750,3,24,27,9,6,1,3,16,76
56,Devin Booker\bookede01,SG,19,PHO,76,51,2108,367,867,.423,99,289,.343,268,578,.464,.480,215,256,.840,27,160,187,200,44,20,160,225,1048
57,Trevor Booker\booketr01,PF,28,UTA,79,2,1632,190,388,.490,12,41,.293,178,347,.513,.505,71,106,.670,166,286,452,84,59,41,81,169,463
58,Chris Bosh\boshch01,PF,31,MIA,53,53,1778,358,767,.467,81,222,.365,277,545,.508,.520,213,268,.795,48,342,390,128,36,34,78,101,1010
59,Avery Bradley\bradlav01,SG,25,BOS,76,72,2536,456,1019,.447,147,407,.361,309,612,.505,.520,96,123,.780,48,172,220,158,117,19,109,164,1155
60,Elton Brand\brandel01,C,36,PHI,17,1,225,31,72,.431,0,1,.000,31,71,.437,.431,8,9,.889,9,54,63,18,9,8,11,32,70
61,Corey Brewer\breweco01,SF,29,HOU,82,12,1669,212,552,.384,61,224,.272,151,328,.460,.439,105,140,.750,42,157,199,109,84,19,78,168,590
62,Aaron Brooks\brookaa01,PG,31,CHI,69,0,1108,188,469,.401,66,185,.357,122,284,.430,.471,49,64,.766,21,80,101,180,30,10,82,132,491
63,Anthony Brown\brownan02,SF,23,LAL,29,11,599,39,126,.310,20,70,.286,19,56,.339,.389,17,20,.850,9,61,70,19,14,5,15,34,115
64,Lorenzo Brown\brownlo01,PG,25,PHO,8,0,61,8,25,.320,1,8,.125,7,17,.412,.340,3,4,.750,0,7,7,11,3,1,9,4,20
65,Markel Brown\brownma02,SG,24,BRK,62,6,982,127,322,.394,38,121,.314,89,201,.443,.453,71,94,.755,23,99,122,91,38,15,54,94,363
66,Kobe Bryant\bryanko01,SF,37,LAL,66,66,1863,398,1113,.358,133,467,.285,265,646,.410,.417,232,281,.826,41,206,247,184,62,13,129,115,1161
67,Chase Budinger\budinch01,SF,27,TOT,66,2,929,104,239,.435,24,86,.279,80,153,.523,.485,39,56,.696,43,107,150,64,32,10,44,62,271
67,Chase Budinger\budinch01,SF,27,IND,49,2,729,81,194,.418,20,69,.290,61,125,.488,.469,34,48,.708,31,90,121,49,29,9,31,46,216
67,Chase Budinger\budinch01,SF,27,PHO,17,0,200,23,45,.511,4,17,.235,19,28,.679,.556,5,8,.625,12,17,29,15,3,1,13,16,55
68,Reggie Bullock\bullore01,SF,24,DET,37,0,429,43,98,.439,22,53,.415,21,45,.467,.551,14,15,.933,14,54,68,27,10,2,8,29,122
69,Trey Burke\burketr01,PG,23,UTA,64,0,1366,262,634,.413,88,256,.344,174,378,.460,.483,67,82,.817,18,94,112,148,35,6,80,86,679
70,Alec Burks\burksal01,SG,24,UTA,31,3,797,137,334,.410,32,79,.405,105,255,.412,.458,106,141,.752,16,93,109,63,18,4,51,71,412
71,Caron Butler\butleca01,SF,35,SAC,17,1,176,25,59,.424,3,18,.167,22,41,.537,.449,10,12,.833,5,17,22,10,9,1,3,19,63
72,Jimmy Butler\butleji01,SG,26,CHI,67,67,2474,470,1035,.454,64,205,.312,406,830,.489,.485,395,475,.832,79,279,358,321,110,43,132,124,1399
73,Rasual Butler\butlera01,SF,36,SAS,46,0,432,49,104,.471,15,49,.306,34,55,.618,.543,11,16,.688,3,53,56,24,13,23,8,11,124
74,Bruno Caboclo\cabocbr01,SF,20,TOR,6,1,43,1,12,.083,1,7,.143,0,5,.000,.125,0,0,,1,1,2,1,2,1,4,2,3
75,Jose Calderon\caldejo01,PG,34,NYK,72,72,2024,209,455,.459,84,203,.414,125,252,.496,.552,42,48,.875,22,207,229,298,63,7,87,135,544
76,Kentavious Caldwell-Pope\caldwke01,SG,22,DET,76,76,2789,403,960,.420,114,369,.309,289,591,.489,.479,185,228,.811,70,212,282,138,110,17,105,167,1105
77,Isaiah Canaan\canaais01,SG,24,PHI,77,39,1966,260,722,.360,176,485,.363,84,237,.354,.482,150,180,.833,20,154,174,137,56,12,91,133,846
78,Clint Capela\capelca01,C,21,HOU,77,35,1471,231,397,.582,0,1,.000,231,396,.583,.582,80,211,.379,194,300,494,47,59,92,60,190,542
79,DeMarre Carroll\carrode01,SF,29,TOR,26,22,786,105,270,.389,46,118,.390,59,152,.388,.474,30,50,.600,31,91,122,27,44,6,28,63,286
80,Vince Carter\cartevi01,SG,39,MEM,60,3,1005,133,343,.388,59,169,.349,74,174,.425,.474,70,84,.833,31,115,146,56,38,16,35,101,395
81,Michael Carter-Williams\cartemi01,PG,24,MIL,54,37,1649,251,555,.452,15,55,.273,236,500,.472,.466,106,162,.654,48,228,276,281,80,41,153,162,623
82,Omri Casspi\casspom01,PF,27,SAC,69,21,1880,299,622,.481,112,274,.409,187,348,.537,.571,103,159,.648,58,352,410,95,56,17,94,154,813
83,Willie Cauley-Stein\caulewi01,C,22,SAC,66,39,1412,191,339,.563,0,2,.000,191,337,.567,.563,81,125,.648,134,218,352,37,48,66,46,146,463
84,Mario Chalmers\chalmma01,PG,29,TOT,61,7,1373,182,444,.410,46,149,.309,136,295,.461,.462,218,262,.832,24,133,157,230,88,13,110,181,628
84,Mario Chalmers\chalmma01,PG,29,MIA,6,0,120,10,32,.313,1,11,.091,9,21,.429,.328,12,13,.923,1,13,14,19,8,1,9,16,33
84,Mario Chalmers\chalmma01,PG,29,MEM,55,7,1253,172,412,.417,45,138,.326,127,274,.464,.472,206,249,.827,23,120,143,211,80,12,101,165,595
85,Tyson Chandler\chandty01,C,33,PHO,66,60,1618,183,314,.583,0,1,.000,183,313,.585,.583,106,171,.620,175,401,576,64,36,44,93,145,472
86,Rakeem Christmas\chrisra01,PF,24,IND,1,0,6,2,2,1.000,0,0,,2,2,1.000,1.000,0,0,,1,0,1,0,0,0,0,1,4
87,Ian Clark\clarkia01,SG,24,GSW,66,1,578,89,202,.441,30,84,.357,59,118,.500,.515,28,34,.824,13,55,68,64,17,13,43,58,236
88,Coty Clarke\clarkco01,SF,23,BOS,3,0,6,2,4,.500,2,2,1.000,0,2,.000,.750,0,0,,0,1,1,0,0,0,1,0,6
89,Jordan Clarkson\clarkjo01,SG,23,LAL,79,79,2552,475,1098,.433,111,320,.347,364,778,.468,.483,164,204,.804,93,220,313,192,88,7,135,168,1225
90,Norris Cole\coleno01,PG,27,NOP,45,23,1198,196,484,.405,33,102,.324,163,382,.427,.439,52,65,.800,10,141,151,167,37,5,75,102,477
91,Darren Collison\collida01,PG,28,SAC,74,15,2219,377,776,.486,87,217,.401,290,559,.519,.542,194,226,.858,28,141,169,318,76,4,130,142,1035
92,Nick Collison\collini01,PF,35,OKC,59,4,699,50,109,.459,0,2,.000,50,107,.467,.459,23,33,.697,68,103,171,52,15,16,50,107,123
93,Mike Conley\conlemi01,PG,28,MEM,56,56,1761,294,696,.422,78,215,.363,216,481,.449,.478,191,229,.834,26,138,164,342,67,16,84,100,857
94,Pat Connaughton\connapa01,SG,23,POR,34,0,143,13,49,.265,5,21,.238,8,28,.286,.316,5,5,1.000,11,21,32,10,2,0,10,6,36
95,Chris Copeland\copelch01,PF,31,MIL,24,1,156,17,51,.333,10,36,.278,7,15,.467,.431,6,7,.857,1,9,10,11,2,0,6,17,50
96,Bryce Cotton\cottobr01,PG,23,TOT,8,0,39,4,10,.400,0,3,.000,4,7,.571,.400,0,0,,0,0,0,3,3,0,5,2,8
96,Bryce Cotton\cottobr01,PG,23,PHO,3,0,33,2,8,.250,0,3,.000,2,5,.400,.250,0,0,,0,0,0,3,3,0,5,2,4
96,Bryce Cotton\cottobr01,PG,23,MEM,5,0,6,2,2,1.000,0,0,,2,2,1.000,1.000,0,0,,0,0,0,0,0,0,0,0,4
97,DeMarcus Cousins\couside01,C,25,SAC,65,65,2246,601,1332,.451,70,210,.333,531,1122,.473,.477,476,663,.718,158,589,747,214,101,92,249,236,1748
98,Robert Covington\covinro01,SF,25,PHI,67,49,1903,274,712,.385,170,482,.353,104,230,.452,.504,140,177,.791,65,354,419,97,105,40,143,232,858
99,Allen Crabbe\crabbal01,SG,23,POR,81,8,2105,311,678,.459,112,285,.393,199,393,.506,.541,98,113,.867,27,189,216,99,63,16,64,192,832
100,Jamal Crawford\crawfja01,SG,35,LAC,79,5,2126,379,939,.404,117,344,.340,262,595,.440,.466,245,271,.904,20,125,145,183,52,12,113,122,1120
101,Jae Crowder\crowdja01,SF,25,BOS,73,73,2308,360,813,.443,122,363,.336,238,450,.529,.518,196,239,.820,70,303,373,135,126,35,83,198,1038
102,Dante Cunningham\cunnida01,SF,28,NOP,80,46,1971,186,412,.451,55,174,.316,131,238,.550,.518,57,82,.695,57,179,236,77,42,33,41,173,484
103,Jared Cunningham\cunnija01,SG,24,TOT,44,3,410,36,105,.343,12,39,.308,24,66,.364,.400,36,55,.655,3,35,38,20,14,2,21,41,120
103,Jared Cunningham\cunnija01,SG,24,CLE,40,3,355,32,91,.352,10,32,.313,22,59,.373,.407,30,48,.625,3,26,29,19,12,2,18,37,104
103,Jared Cunningham\cunnija01,SG,24,MIL,4,0,55,4,14,.286,2,7,.286,2,7,.286,.357,6,7,.857,0,9,9,1,2,0,3,4,16
104,Seth Curry\curryse01,PG,25,SAC,44,9,692,102,224,.455,50,111,.450,52,113,.460,.567,45,54,.833,9,51,60,67,22,3,36,41,299
105,Stephen Curry\curryst01,PG,27,GSW,79,79,2700,805,1598,.504,402,886,.454,403,712,.566,.630,363,400,.908,68,362,430,527,169,15,262,161,2375
106,Troy Daniels\danietr01,SG,24,CHO,43,0,476,89,187,.476,59,122,.484,30,65,.462,.634,5,9,.556,7,50,57,21,11,3,24,40,242
107,Anthony Davis\davisan02,C,22,NOP,61,61,2164,560,1136,.493,35,108,.324,525,1028,.511,.508,326,430,.758,130,497,627,116,78,125,121,148,1481
108,Ed Davis\davised01,PF,26,POR,81,0,1684,206,337,.611,0,0,,206,337,.611,.611,114,204,.559,224,375,599,88,57,72,64,202,526
109,Branden Dawson\dawsobr01,PF,22,LAC,6,0,29,2,5,.400,0,0,,2,5,.400,.400,1,1,1.000,2,2,4,0,0,1,0,2,5
110,Dewayne Dedmon\dedmode01,C,26,ORL,58,20,705,99,177,.559,0,0,,99,177,.559,.559,57,76,.750,67,161,228,13,22,46,32,109,255
111,Bryce Dejean-Jones\dejeabr01,SG,23,NOP,14,11,279,28,69,.406,12,32,.375,16,37,.432,.493,11,21,.524,8,40,48,15,10,2,11,17,79
112,Sam Dekker\dekkesa01,PF,21,HOU,3,0,6,0,0,,0,0,,0,0,,,0,0,,0,1,1,0,1,0,0,0,0
113,Matthew Dellavedova\dellama01,PG,25,CLE,76,14,1867,207,511,.405,98,239,.410,109,272,.401,.501,57,66,.864,33,129,162,337,44,9,116,178,569
114,Luol Deng\denglu01,PF,30,MIA,74,73,2394,339,745,.455,88,256,.344,251,489,.513,.514,145,192,.755,108,335,443,140,74,29,81,122,911
115,DeMar DeRozan\derozde01,SG,26,TOR,78,78,2804,614,1377,.446,47,139,.338,567,1238,.458,.463,555,653,.850,64,285,349,315,81,21,175,167,1830
116,Boris Diaw\diawbo01,PF,33,SAS,76,4,1386,202,383,.527,25,69,.362,177,314,.564,.560,56,76,.737,58,175,233,176,26,21,97,102,485
117,Gorgui Dieng\dienggo01,C,26,MIN,82,39,2220,308,579,.532,6,20,.300,302,559,.540,.537,205,248,.827,157,428,585,143,94,96,140,219,827
118,Spencer Dinwiddie\dinwisp01,PG,22,DET,12,0,159,19,54,.352,1,10,.100,18,44,.409,.361,19,33,.576,4,13,17,22,3,0,7,20,58
119,Toney Douglas\douglto01,PG,29,NOP,61,18,1262,183,445,.411,81,203,.399,102,242,.421,.502,84,99,.848,25,118,143,157,70,5,64,131,531
120,Goran Dragic\dragigo01,PG,29,MIA,72,72,2363,417,875,.477,64,205,.312,353,670,.527,.513,120,165,.727,54,223,277,419,71,17,185,188,1018
121,Andre Drummond\drumman01,C,22,DET,81,81,2666,552,1060,.521,2,6,.333,550,1054,.522,.522,208,586,.355,395,803,1198,67,119,112,155,245,1314
122,Jared Dudley\dudleja01,PF,30,WAS,81,41,2098,233,487,.478,100,238,.420,133,249,.534,.581,72,98,.735,54,232,286,170,75,18,80,190,638
123,Duje Dukan\dukandu01,SF,24,SAC,1,0,24,2,10,.200,2,5,.400,0,5,.000,.300,0,0,,2,2,4,1,1,0,0,2,6
124,Tim Duncan\duncati01,C,39,SAS,61,60,1536,215,441,.488,0,2,.000,215,439,.490,.488,92,131,.702,115,332,447,163,47,78,90,125,522
125,Mike Dunleavy\dunlemi02,SF,35,CHI,31,30,703,77,188,.410,39,99,.394,38,89,.427,.513,29,37,.784,8,75,83,39,14,10,26,66,222
126,Kevin Durant\duranke01,SF,27,OKC,72,72,2578,698,1381,.505,186,481,.387,512,900,.569,.573,447,498,.898,45,544,589,361,69,85,250,137,2029
127,Cleanthony Early\earlycl01,SF,24,NYK,17,2,154,12,40,.300,4,15,.267,8,25,.320,.350,3,4,.750,4,22,26,6,2,3,9,16,31
128,Jarell Eddie\eddieja01,SF,24,WAS,26,0,147,20,65,.308,15,47,.319,5,18,.278,.423,8,8,1.000,2,21,23,5,5,1,1,5,63
129,Wayne Ellington\ellinwa01,SG,28,BRK,76,41,1615,218,561,.389,96,268,.358,122,293,.416,.474,54,63,.857,20,154,174,83,48,5,45,82,586
130,Monta Ellis\ellismo01,SG,30,IND,81,81,2734,436,1021,.427,87,282,.309,349,739,.472,.470,162,206,.786,42,229,271,383,150,37,203,174,1121
131,James Ennis\ennisja01,SF,25,TOT,22,5,329,54,113,.478,26,58,.448,28,55,.509,.593,25,34,.735,21,21,42,21,16,5,19,28,159
131,James Ennis\ennisja01,SF,25,MIA,3,0,7,0,0,,0,0,,0,0,,,0,0,,0,0,0,1,0,0,0,1,0
131,James Ennis\ennisja01,SF,25,MEM,10,0,40,4,13,.308,2,8,.250,2,5,.400,.385,6,10,.600,4,3,7,2,4,2,2,1,16
131,James Ennis\ennisja01,SF,25,NOP,9,5,282,50,100,.500,24,50,.480,26,50,.520,.620,19,24,.792,17,18,35,18,12,3,17,26,143
132,Tyler Ennis\ennisty01,PG,21,MIL,46,7,654,84,187,.449,13,39,.333,71,148,.480,.484,25,34,.735,13,62,75,95,25,1,46,64,206
133,Jeremy Evans\evansje01,SF,28,DAL,30,2,251,26,48,.542,4,16,.250,22,32,.688,.583,15,21,.714,11,43,54,2,6,9,7,19,71
134,Tyreke Evans\evansty01,SG,26,NOP,25,25,765,136,314,.433,33,85,.388,103,229,.450,.486,74,93,.796,20,109,129,164,32,8,73,66,379
135,Festus Ezeli\ezelife01,C,26,GSW,46,13,770,125,228,.548,0,0,,125,228,.548,.548,70,132,.530,91,166,257,32,18,50,38,94,320
136,Kenneth Faried\farieke01,PF,26,DEN,67,64,1694,349,626,.558,1,2,.500,348,624,.558,.558,136,222,.613,235,346,581,79,32,60,91,169,835
137,Jordan Farmar\farmajo01,PG,29,MEM,12,10,291,42,100,.420,16,45,.356,26,55,.473,.500,10,10,1.000,4,21,25,37,15,2,18,22,110
138,Derrick Favors\favorde01,PF,24,UTA,62,59,1983,418,811,.515,0,4,.000,418,807,.518,.515,180,254,.709,169,334,503,94,74,91,104,150,1016
139,Cristiano Felicio\feliccr01,C,23,CHI,31,4,321,40,72,.556,0,4,.000,40,68,.588,.556,25,35,.714,30,72,102,26,6,13,13,31,105
140,Raymond Felton\feltora01,PG,31,DAL,80,31,2192,277,682,.406,60,213,.282,217,469,.463,.450,149,176,.847,36,222,258,284,68,15,121,141,763
141,Evan Fournier\fournev01,SF,23,ORL,79,71,2566,429,929,.462,156,390,.400,273,539,.506,.546,199,238,.836,33,192,225,213,96,2,133,214,1213
142,Randy Foye\foyera01,SG,32,TOT,81,8,1642,169,482,.351,75,250,.300,94,232,.405,.428,61,74,.824,24,132,156,161,39,29,86,131,474
142,Randy Foye\foyera01,SG,32,DEN,54,7,1070,117,333,.351,50,169,.296,67,164,.409,.426,39,47,.830,16,89,105,112,26,16,58,83,323
142,Randy Foye\foyera01,SG,32,OKC,27,1,572,52,149,.349,25,81,.309,27,68,.397,.433,22,27,.815,8,43,51,49,13,13,28,48,151
143,Tim Frazier\fraziti01,PG,25,TOT,51,2,741,96,229,.419,16,48,.333,80,181,.442,.454,53,74,.716,26,84,110,162,33,2,65,73,261
143,Tim Frazier\fraziti01,PG,25,POR,35,1,272,20,60,.333,3,17,.176,17,43,.395,.358,8,15,.533,11,28,39,42,10,1,27,31,51
143,Tim Frazier\fraziti01,PG,25,NOP,16,1,469,76,169,.450,13,31,.419,63,138,.457,.488,45,59,.763,15,56,71,120,23,1,38,42,210
144,Jimmer Fredette\fredeji01,SG,26,TOT,6,0,18,2,5,.400,1,2,.500,1,3,.333,.500,4,5,.800,0,0,0,1,1,0,2,2,9
144,Jimmer Fredette\fredeji01,SG,26,NOP,4,0,13,1,4,.250,0,1,.000,1,3,.333,.250,0,0,,0,0,0,1,1,0,1,1,2
144,Jimmer Fredette\fredeji01,SG,26,NYK,2,0,5,1,1,1.000,1,1,1.000,0,0,,1.500,4,5,.800,0,0,0,0,0,0,1,1,7
145,Channing Frye\fryech01,PF-C,32,TOT,70,32,1200,152,347,.438,91,235,.387,61,112,.545,.569,30,35,.857,35,199,234,71,29,28,43,127,425
145,Channing Frye\fryech01,PF,32,ORL,44,29,754,81,186,.435,48,121,.397,33,65,.508,.565,19,21,.905,23,118,141,45,21,20,30,71,229
145,Channing Frye\fryech01,C,32,CLE,26,3,446,71,161,.441,43,114,.377,28,47,.596,.575,11,14,.786,12,81,93,26,8,8,13,56,196
146,Danilo Gallinari\gallida01,SF,27,DEN,53,53,1839,287,700,.410,87,239,.364,200,461,.434,.472,375,432,.868,52,229,281,135,42,19,77,87,1036
147,Langston Galloway\gallola01,PG,24,NYK,82,7,2033,231,588,.393,77,224,.344,154,364,.423,.458,86,114,.754,43,245,288,207,77,22,61,177,625
148,Kevin Garnett\garneke01,PF,39,MIN,38,38,556,54,115,.470,0,1,.000,54,114,.474,.470,14,21,.667,15,135,150,62,28,10,16,70,122
149,Marc Gasol\gasolma01,C,31,MEM,52,52,1791,328,707,.464,2,3,.667,326,704,.463,.465,203,245,.829,58,304,362,196,50,70,118,141,861
150,Pau Gasol\gasolpa01,C,35,CHI,72,72,2291,467,995,.469,24,69,.348,443,926,.478,.481,229,289,.792,155,638,793,294,42,146,164,148,1187
151,Rudy Gay\gayru01,SF,29,SAC,70,70,2379,466,1007,.463,74,215,.344,392,792,.495,.500,198,254,.780,103,353,456,120,100,51,139,184,1204
152,Alonzo Gee\geeal01,SF,28,NOP,73,38,1632,132,255,.518,17,60,.283,115,195,.590,.551,44,66,.667,60,185,245,72,63,13,55,169,325
153,Paul George\georgpa01,SF,25,IND,81,81,2819,605,1449,.418,210,566,.371,395,883,.447,.490,454,528,.860,79,484,563,329,152,29,265,230,1874
154,Taj Gibson\gibsota01,PF,30,CHI,73,55,1936,263,500,.526,0,3,.000,263,497,.529,.526,101,146,.692,206,298,504,106,47,77,78,180,627
155,Manu Ginobili\ginobma01,SG,38,SAS,58,0,1134,197,435,.453,70,179,.391,127,256,.496,.533,91,112,.813,26,120,146,177,66,11,99,99,555
156,Rudy Gobert\goberru01,C,23,UTA,61,60,1932,198,354,.559,0,0,,198,354,.559,.559,161,283,.569,208,460,668,91,45,135,114,163,557
157,Drew Gooden\goodedr01,PF,34,WAS,30,0,305,33,103,.320,7,41,.171,26,62,.419,.354,9,14,.643,28,57,85,13,8,11,13,40,82
158,Archie Goodwin\goodwar01,PG,21,PHO,57,13,1114,176,422,.417,23,99,.232,153,323,.474,.444,130,193,.674,27,115,142,118,27,13,100,84,505
159,Aaron Gordon\gordoaa01,PF,20,ORL,78,37,1863,274,579,.473,42,142,.296,232,437,.531,.509,129,193,.668,154,353,507,128,59,55,66,153,719
160,Eric Gordon\gordoer01,SG,27,NOP,45,44,1481,231,552,.418,113,294,.384,118,258,.457,.521,111,125,.888,10,89,99,121,43,14,73,98,686
161,Marcin Gortat\gortama01,C,31,WAS,75,74,2256,433,764,.567,0,1,.000,433,763,.567,.567,146,207,.705,222,519,741,106,47,96,121,193,1012
162,Andrew Goudelock\goudean01,PG,27,HOU,8,0,50,9,20,.450,1,9,.111,8,11,.727,.475,3,4,.750,1,1,2,4,6,2,7,4,22
163,Jerami Grant\grantje01,PF,21,PHI,77,52,2066,251,599,.419,35,146,.240,216,453,.477,.448,212,322,.658,99,262,361,135,54,127,110,215,749
164,Jerian Grant\grantje02,PG,23,NYK,76,6,1265,154,391,.394,22,100,.220,132,291,.454,.422,96,123,.780,23,120,143,177,50,10,87,97,426
165,Danny Green\greenda02,SG,28,SAS,79,79,2062,211,561,.376,116,349,.332,95,212,.448,.480,34,46,.739,48,255,303,141,79,64,75,141,572
166,Draymond Green\greendr01,PF,25,GSW,81,81,2808,401,819,.490,100,258,.388,301,561,.537,.551,229,329,.696,134,635,769,598,119,113,259,240,1131
167,Erick Green\greener01,PG,24,TOT,9,0,42,5,13,.385,1,5,.200,4,8,.500,.423,2,2,1.000,3,3,6,3,1,0,0,4,13
167,Erick Green\greener01,PG,24,DEN,3,0,7,0,1,.000,0,1,.000,0,0,,.000,0,0,,0,1,1,1,0,0,0,0,0
167,Erick Green\greener01,PG,24,UTA,6,0,35,5,12,.417,1,4,.250,4,8,.500,.458,2,2,1.000,3,2,5,2,1,0,0,4,13
168,Gerald Green\greenge01,SG,30,MIA,69,14,1557,230,587,.392,84,260,.323,146,327,.446,.463,72,92,.783,25,138,163,56,38,19,46,123,616
169,JaMychal Green\greenja01,PF,25,MEM,78,15,1446,230,495,.465,15,45,.333,215,450,.478,.480,103,137,.752,139,234,373,67,46,33,83,189,578
170,Jeff Green\greenje02,SF,29,TOT,80,41,2253,354,824,.430,67,213,.315,287,611,.470,.470,164,220,.745,74,258,332,138,58,40,93,164,939
170,Jeff Green\greenje02,SF,29,MEM,53,31,1544,240,557,.431,42,136,.309,198,421,.470,.469,124,155,.800,55,186,241,98,40,19,69,102,646
170,Jeff Green\greenje02,SF,29,LAC,27,10,709,114,267,.427,25,77,.325,89,190,.468,.474,40,65,.615,19,72,91,40,18,21,24,62,293
171,Blake Griffin\griffbl01,PF,26,LAC,35,35,1170,301,603,.499,6,18,.333,295,585,.504,.504,141,194,.727,51,243,294,170,28,17,83,95,749
172,Jorge Gutierrez\gutiejo01,PG,27,CHO,12,0,63,6,11,.545,0,2,.000,6,9,.667,.545,10,11,.909,0,7,7,17,3,0,6,3,22
173,P.J. Hairston\hairspj02,SF,23,TOT,66,52,1313,145,408,.355,70,241,.290,75,167,.449,.441,50,64,.781,25,149,174,38,32,11,41,137,410
173,P.J. Hairston\hairspj02,SF,23,CHO,48,43,938,99,276,.359,54,172,.314,45,104,.433,.457,34,42,.810,18,110,128,29,24,7,24,106,286
173,P.J. Hairston\hairspj02,SF,23,MEM,18,9,375,46,132,.348,16,69,.232,30,63,.476,.409,16,22,.727,7,39,46,9,8,4,17,31,124
174,Jordan Hamilton\hamiljo02,SF,25,NOP,11,4,304,49,116,.422,13,45,.289,36,71,.507,.478,14,21,.667,12,50,62,25,8,3,17,24,125
175,Tyler Hansbrough\hansbty01,PF,30,CHO,44,0,343,32,71,.451,2,3,.667,30,68,.441,.465,38,65,.585,40,49,89,8,12,7,12,55,104
176,Tim Hardaway\hardati02,SG,23,ATL,51,1,864,114,265,.430,48,142,.338,66,123,.537,.521,50,56,.893,7,79,86,51,21,7,23,48,326
177,James Harden\hardeja01,SG,26,HOU,82,82,3125,710,1617,.439,236,657,.359,474,960,.494,.512,720,837,.860,63,438,501,612,139,51,374,229,2376
178,Maurice Harkless\harklma01,SF,22,POR,78,14,1457,195,411,.474,39,140,.279,156,271,.576,.522,69,111,.622,101,179,280,67,49,35,62,124,498
179,Justin Harper\harpeju01,PF,26,DET,5,0,35,4,10,.400,4,9,.444,0,1,.000,.600,1,2,.500,0,1,1,0,1,0,2,3,13
180,Montrezl Harrell\harremo01,PF,22,HOU,39,1,379,58,90,.644,0,1,.000,58,89,.652,.644,24,46,.522,25,40,65,17,11,11,17,48,140
181,Devin Harris\harride01,PG,32,DAL,64,0,1280,167,374,.447,52,158,.329,115,216,.532,.516,101,140,.721,18,120,138,118,60,13,66,124,487
182,Gary Harris\harriga01,SG,21,DEN,76,76,2439,359,765,.469,105,297,.354,254,468,.543,.538,109,133,.820,54,166,220,147,97,18,98,143,932
183,Joe Harris\harrijo01,SG,24,CLE,5,0,15,1,4,.250,1,4,.250,0,0,,.375,0,0,,0,3,3,2,0,0,1,1,3
184,Tobias Harris\harrito02,PF,23,TOT,76,74,2513,417,889,.469,80,239,.335,337,650,.518,.514,202,243,.831,96,414,510,169,65,40,108,153,1116
184,Tobias Harris\harrito02,PF,23,ORL,49,49,1610,251,541,.464,47,151,.311,204,390,.523,.507,120,153,.784,71,271,342,99,47,28,78,91,669
184,Tobias Harris\harrito02,PF,23,DET,27,25,903,166,348,.477,33,88,.375,133,260,.512,.524,82,90,.911,25,143,168,70,18,12,30,62,447
185,Aaron Harrison\harriaa01,SG,21,CHO,21,0,93,5,19,.263,3,10,.300,2,9,.222,.342,5,12,.417,4,11,15,2,6,0,4,10,18
186,Udonis Haslem\hasleud01,PF,35,MIA,37,0,260,23,61,.377,1,9,.111,22,52,.423,.385,12,16,.750,10,65,75,14,5,2,5,25,59
187,Spencer Hawes\hawessp01,PF,27,CHO,57,6,1035,124,306,.405,38,102,.373,86,204,.422,.467,54,65,.831,51,193,244,109,22,27,58,111,340
188,Chuck Hayes\hayesch01,C,32,HOU,2,0,24,1,2,.500,0,0,,1,2,.500,.500,2,2,1.000,0,8,8,2,0,0,3,6,4
189,Gordon Hayward\haywago01,SF,25,UTA,80,80,2893,521,1202,.433,143,410,.349,378,792,.477,.493,393,477,.824,61,336,397,296,95,27,202,183,1578
190,Gerald Henderson\hendege02,SG,28,POR,72,0,1431,232,529,.439,48,136,.353,184,393,.468,.484,112,146,.767,30,181,211,75,39,19,68,87,624
191,John Henson\hensojo01,C,25,MIL,57,1,960,164,291,.564,0,1,.000,164,290,.566,.564,69,117,.590,87,134,221,54,18,109,64,131,397
192,Mario Hezonja\hezonma01,SF,20,ORL,79,9,1413,181,418,.433,67,192,.349,114,226,.504,.513,49,54,.907,28,148,176,109,39,17,97,124,478
193,Roy Hibbert\hibbero01,C,29,LAL,81,81,1878,182,411,.443,0,2,.000,182,409,.445,.443,117,145,.807,132,266,398,95,32,110,76,252,481
194,J.J. Hickson\hicksjj01,C,27,TOT,35,9,436,80,155,.516,0,1,.000,80,154,.519,.516,46,103,.447,39,93,132,23,15,14,25,47,206
194,J.J. Hickson\hicksjj01,C,27,DEN,20,9,305,55,109,.505,0,0,,55,109,.505,.505,27,59,.458,22,65,87,16,10,12,16,35,137
194,J.J. Hickson\hicksjj01,C,27,WAS,15,0,131,25,46,.543,0,1,.000,25,45,.556,.543,19,44,.432,17,28,45,7,5,2,9,12,69
195,Nene Hilario\hilarne01,PF,33,WAS,57,11,1094,209,384,.544,0,3,.000,209,381,.549,.544,107,185,.578,52,207,259,97,54,26,76,156,525
196,George Hill\hillge01,PG,29,IND,74,73,2524,326,739,.441,128,314,.408,198,425,.466,.528,114,150,.760,58,240,298,259,83,17,101,149,894
197,Jordan Hill\hilljo01,C,28,IND,73,11,1513,278,549,.506,0,1,.000,278,548,.507,.506,89,125,.712,156,295,451,87,36,37,92,155,645
198,Solomon Hill\hillso01,SF,24,IND,59,3,866,93,208,.447,24,74,.324,69,134,.515,.505,36,42,.857,39,127,166,57,37,11,33,68,246
199,Darrun Hilliard\hillida01,SG,22,DET,38,2,383,52,131,.397,19,50,.380,33,81,.407,.469,29,40,.725,5,40,45,27,9,1,19,28,152
200,Kirk Hinrich\hinriki01,PG,35,TOT,46,7,631,49,129,.380,24,62,.387,25,67,.373,.473,15,16,.938,8,62,70,73,15,2,30,64,137
200,Kirk Hinrich\hinriki01,PG,35,CHI,35,7,555,47,118,.398,23,56,.411,24,62,.387,.496,15,16,.938,7,51,58,59,13,1,27,63,132
200,Kirk Hinrich\hinriki01,PG,35,ATL,11,0,76,2,11,.182,1,6,.167,1,5,.200,.227,0,0,,1,11,12,14,2,1,3,1,5
201,Jrue Holiday\holidjr01,PG,25,NOP,65,23,1831,410,935,.439,87,259,.336,323,676,.478,.485,182,216,.843,27,168,195,391,88,22,167,148,1089
202,Justin Holiday\holidju01,SG,26,TOT,53,5,773,88,228,.386,36,105,.343,52,123,.423,.465,27,37,.730,12,78,90,56,32,19,39,61,239
202,Justin Holiday\holidju01,SG,26,ATL,26,1,263,24,73,.329,10,45,.222,14,28,.500,.397,5,10,.500,4,23,27,11,13,4,13,21,63
202,Justin Holiday\holidju01,SG,26,CHI,27,4,510,64,155,.413,26,60,.433,38,95,.400,.497,22,27,.815,8,55,63,45,19,15,26,40,176
203,Ryan Hollins\holliry01,C,31,TOT,37,12,460,49,79,.620,0,0,,49,79,.620,.620,26,42,.619,47,51,98,10,6,21,24,62,124
203,Ryan Hollins\holliry01,C,31,WAS,5,3,48,4,7,.571,0,0,,4,7,.571,.571,0,0,,7,4,11,0,0,1,3,4,8
203,Ryan Hollins\holliry01,C,31,MEM,32,9,412,45,72,.625,0,0,,45,72,.625,.625,26,42,.619,40,47,87,10,6,20,21,58,116
204,Rondae Hollis-Jefferson\holliro01,SF,21,BRK,29,17,615,63,138,.457,4,14,.286,59,124,.476,.471,37,52,.712,39,115,154,43,39,16,26,61,167
205,Richaun Holmes\holmeri01,PF,22,PHI,51,1,702,114,222,.514,8,44,.182,106,178,.596,.532,51,74,.689,62,73,135,33,19,40,32,92,287
206,Rodney Hood\hoodro01,SG,23,UTA,79,79,2541,408,972,.420,161,449,.359,247,523,.472,.503,172,200,.860,38,229,267,213,73,16,125,202,1149
207,Al Horford\horfoal01,C,29,ATL,82,82,2631,529,1048,.505,88,256,.344,441,792,.557,.547,103,129,.798,148,448,596,263,68,121,107,163,1249
208,Dwight Howard\howardw01,C,30,HOU,71,71,2280,372,600,.620,0,6,.000,372,594,.626,.620,232,474,.489,238,597,835,98,69,113,166,219,976
209,Marcelo Huertas\huertma01,PG,32,LAL,53,0,869,97,230,.422,16,61,.262,81,169,.479,.457,27,29,.931,18,72,90,182,26,7,80,76,237
210,Josh Huestis\huestjo01,PF,24,OKC,5,0,55,5,12,.417,4,6,.667,1,6,.167,.583,0,4,.000,2,8,10,0,1,2,3,3,14
211,Kris Humphries\humphkr01,PF,30,TOT,53,17,835,121,295,.410,34,108,.315,87,187,.465,.468,67,84,.798,57,161,218,36,16,23,38,94,343
211,Kris Humphries\humphkr01,PF,30,WAS,28,14,466,64,158,.405,23,67,.343,41,91,.451,.478,29,31,.935,26,89,115,16,3,14,20,42,180
211,Kris Humphries\humphkr01,PF,30,PHO,4,3,74,10,36,.278,3,10,.300,7,26,.269,.319,6,8,.750,11,21,32,7,3,2,4,8,29
211,Kris Humphries\humphkr01,PF,30,ATL,21,0,295,47,101,.465,8,31,.258,39,70,.557,.505,32,45,.711,20,51,71,13,10,7,14,44,134
212,R.J. Hunter\hunterj01,SG,22,BOS,36,0,315,36,98,.367,19,63,.302,17,35,.486,.464,6,7,.857,2,35,37,13,14,4,11,29,97
213,Serge Ibaka\ibakase01,PF,26,OKC,78,78,2500,416,869,.479,60,184,.326,356,685,.520,.513,91,121,.752,141,392,533,66,38,148,108,211,983
214,Andre Iguodala\iguodan01,SF,32,GSW,65,1,1732,176,368,.478,54,154,.351,122,214,.570,.552,51,83,.614,52,211,263,219,73,19,79,102,457
215,Ersan Ilyasova\ilyaser01,PF,28,TOT,74,56,1881,280,661,.424,96,259,.371,184,402,.458,.496,111,154,.721,144,259,403,67,52,33,71,171,767
215,Ersan Ilyasova\ilyaser01,PF,28,DET,52,52,1434,216,508,.425,78,215,.363,138,293,.471,.502,79,109,.725,99,183,282,55,38,27,59,120,589
215,Ersan Ilyasova\ilyaser01,PF,28,ORL,22,4,447,64,153,.418,18,44,.409,46,109,.422,.477,32,45,.711,45,76,121,12,14,6,12,51,178
216,Joe Ingles\inglejo01,SF,28,UTA,81,2,1241,124,291,.426,81,210,.386,43,81,.531,.565,13,18,.722,19,132,151,96,55,4,65,98,342
217,Damien Inglis\inglida01,SF,20,MIL,20,1,156,13,37,.351,3,13,.231,10,24,.417,.392,7,8,.875,2,29,31,10,6,3,11,11,36
218,Kyrie Irving\irvinky01,PG,23,CLE,53,53,1667,394,879,.448,84,262,.321,310,617,.502,.496,169,191,.885,44,113,157,249,56,18,124,107,1041
219,Jarrett Jack\jackja01,PG,32,BRK,32,32,1027,140,358,.391,31,102,.304,109,256,.426,.434,100,112,.893,9,127,136,236,34,7,94,77,411
220,Reggie Jackson\jacksre01,PG,25,DET,79,79,2424,540,1244,.434,118,334,.353,422,910,.464,.482,291,337,.864,58,195,253,492,59,11,223,187,1489
221,LeBron James\jamesle01,SF,31,CLE,76,76,2709,737,1416,.520,87,282,.309,650,1134,.573,.551,359,491,.731,111,454,565,514,104,49,249,143,1920
222,Al Jefferson\jeffeal01,C,31,CHO,47,18,1096,245,505,.485,0,0,,245,505,.485,.485,72,111,.649,57,244,301,70,30,41,34,117,562
223,Cory Jefferson\jeffeco01,PF,25,PHO,8,0,50,9,22,.409,0,1,.000,9,21,.429,.409,4,6,.667,6,10,16,0,0,1,0,8,22
224,Richard Jefferson\jefferi01,SF,35,CLE,74,5,1326,143,312,.458,66,173,.382,77,139,.554,.564,58,87,.667,15,113,128,59,33,14,43,129,410
225,John Jenkins\jenkijo01,SG,24,TOT,43,3,480,71,160,.444,16,51,.314,55,109,.505,.494,20,24,.833,8,49,57,35,8,1,27,22,178
225,John Jenkins\jenkijo01,SG,24,DAL,21,1,193,29,70,.414,3,19,.158,26,51,.510,.436,8,9,.889,4,18,22,9,3,0,11,11,69
225,John Jenkins\jenkijo01,SG,24,PHO,22,2,287,42,90,.467,13,32,.406,29,58,.500,.539,12,15,.800,4,31,35,26,5,1,16,11,109
226,Brandon Jennings\jennibr01,PG,26,TOT,48,7,868,112,304,.368,51,155,.329,61,149,.409,.452,57,78,.731,16,80,96,170,29,7,57,57,332
226,Brandon Jennings\jennibr01,PG,26,DET,23,1,416,53,143,.371,24,77,.312,29,66,.439,.455,27,38,.711,5,41,46,70,11,2,22,24,157
226,Brandon Jennings\jennibr01,PG,26,ORL,25,6,452,59,161,.366,27,78,.346,32,83,.386,.450,30,40,.750,11,39,50,100,18,5,35,33,175
227,Jonas Jerebko\jerebjo01,PF,28,BOS,78,0,1176,118,286,.413,43,108,.398,75,178,.421,.488,61,78,.782,77,211,288,62,20,24,52,137,340
228,Amir Johnson\johnsam01,PF,28,BOS,79,76,1800,249,426,.585,10,43,.233,239,383,.624,.596,69,121,.570,178,327,505,138,52,83,94,214,577
229,Chris Johnson\johnsch04,SF,25,UTA,70,2,857,72,194,.371,27,99,.273,45,95,.474,.441,34,42,.810,27,105,132,45,32,20,40,100,205
230,James Johnson\johnsja01,PF,28,TOR,57,32,926,114,240,.475,20,66,.303,94,174,.540,.517,39,68,.574,28,98,126,67,29,33,54,84,287
231,Joe Johnson\johnsjo02,SF,34,TOT,81,81,2703,377,859,.439,120,313,.383,257,546,.471,.509,118,142,.831,49,243,292,318,61,4,159,146,992
231,Joe Johnson\johnsjo02,SF,34,BRK,57,57,1934,247,608,.406,85,229,.371,162,379,.427,.476,92,108,.852,34,190,224,232,40,2,116,100,671
231,Joe Johnson\johnsjo02,SF,34,MIA,24,24,769,130,251,.518,35,84,.417,95,167,.569,.588,26,34,.765,15,53,68,86,21,2,43,46,321
232,Orlando Johnson\johnsor01,SG,26,TOT,7,1,101,9,34,.265,2,10,.200,7,24,.292,.294,6,8,.750,4,11,15,2,3,3,4,9,26
232,Orlando Johnson\johnsor01,SG,26,PHO,2,0,47,5,17,.294,1,5,.200,4,12,.333,.324,5,6,.833,3,6,9,0,2,3,1,5,16
232,Orlando Johnson\johnsor01,SG,26,NOP,5,1,54,4,17,.235,1,5,.200,3,12,.250,.265,1,2,.500,1,5,6,2,1,0,3,4,10
233,Stanley Johnson\johnsst04,SF,19,DET,73,6,1687,225,600,.375,63,205,.307,162,395,.410,.428,80,102,.784,58,248,306,118,55,12,114,178,593
234,Tyler Johnson\johnsty01,SG,23,MIA,36,5,863,118,243,.486,27,71,.380,91,172,.529,.541,51,64,.797,28,81,109,79,24,14,47,66,314
235,Wesley Johnson\johnswe01,SF,28,LAC,80,9,1666,208,515,.404,103,309,.333,105,206,.510,.504,30,46,.652,37,211,248,49,89,56,54,173,549
236,Nikola Jokic\jokicni01,C,20,DEN,80,55,1733,307,600,.512,28,84,.333,279,516,.541,.535,154,190,.811,181,379,560,189,79,50,104,208,796
237,Dahntay Jones\jonesda02,SF,35,CLE,1,0,42,6,14,.429,1,2,.500,5,12,.417,.464,0,0,,1,4,5,2,1,2,0,6,13
238,James Jones\jonesja02,SF,35,CLE,48,0,463,58,142,.408,41,104,.394,17,38,.447,.553,21,26,.808,8,42,50,14,11,10,13,50,178
239,Terrence Jones\joneste01,PF,24,HOU,50,11,1044,166,367,.452,25,79,.316,141,288,.490,.486,77,116,.664,62,149,211,41,23,39,49,86,434
240,Tyus Jones\jonesty01,PG,19,MIN,37,0,573,56,156,.359,16,53,.302,40,103,.388,.410,28,39,.718,7,40,47,108,31,3,33,33,156
241,DeAndre Jordan\jordade01,C,27,LAC,77,77,2598,357,508,.703,0,1,.000,357,507,.704,.703,266,619,.430,267,792,1059,90,51,177,107,207,980
242,Cory Joseph\josepco01,SG,24,TOR,80,4,2046,257,585,.439,30,110,.273,227,475,.478,.465,133,174,.764,39,171,210,250,63,20,102,131,677
243,Chris Kaman\kamanch01,C,33,POR,16,2,112,20,43,.465,1,4,.250,19,39,.487,.477,3,3,1.000,7,17,24,11,1,1,8,15,44
244,Frank Kaminsky\kaminfr01,C,22,CHO,81,3,1708,215,525,.410,68,202,.337,147,323,.455,.474,108,148,.730,69,266,335,98,38,43,58,126,606
245,Enes Kanter\kanteen01,C,23,OKC,82,1,1721,414,719,.576,10,21,.476,404,698,.579,.583,200,251,.797,249,415,664,33,26,33,115,166,1038
246,Sergey Karasev\karasse01,SF,22,BRK,40,5,399,30,74,.405,11,37,.297,19,37,.514,.480,26,28,.929,8,50,58,35,6,2,22,27,97
247,Sasha Kaun\kaunsa01,C,30,CLE,25,0,95,9,17,.529,0,0,,9,17,.529,.529,5,11,.455,12,14,26,3,4,5,7,11,23
248,Ryan Kelly\kellyry01,PF,24,LAL,36,0,470,55,149,.369,5,37,.135,50,112,.446,.386,37,54,.685,21,100,121,20,13,10,18,39,152
249,Michael Kidd-Gilchrist\kiddgmi01,SF,22,CHO,7,7,205,33,61,.541,3,7,.429,30,54,.556,.566,20,29,.690,12,33,45,9,3,3,8,9,89
250,Sean Kilpatrick\kilpase01,SG,26,TOT,31,0,616,123,270,.456,39,114,.342,84,156,.538,.528,60,67,.896,12,44,56,29,12,2,31,37,345
250,Sean Kilpatrick\kilpase01,SG,26,DEN,8,0,82,8,21,.381,4,17,.235,4,4,1.000,.476,7,8,.875,2,4,6,3,2,0,4,7,27
250,Sean Kilpatrick\kilpase01,SG,26,BRK,23,0,534,115,249,.462,35,97,.361,80,152,.526,.532,53,59,.898,10,40,50,26,10,2,27,30,318
251,Brandon Knight\knighbr03,SG,24,PHO,52,50,1870,371,895,.415,120,351,.342,251,544,.461,.482,156,183,.852,36,166,202,263,61,20,177,124,1018
252,Kyle Korver\korveky01,SG,34,ATL,80,80,2401,268,616,.435,158,397,.398,110,219,.502,.563,45,54,.833,14,246,260,164,60,35,98,161,739
253,Kosta Koufos\koufoko01,C,26,SAC,78,14,1482,236,444,.532,0,0,,236,444,.532,.532,57,104,.548,169,254,423,33,40,70,48,185,529
254,Jeremy Lamb\lambje01,SG,23,CHO,66,0,1227,230,510,.451,56,181,.309,174,329,.529,.506,64,88,.727,44,208,252,77,42,30,50,105,580
255,Carl Landry\landrca01,PF,32,PHI,36,12,569,139,250,.556,6,13,.462,133,237,.561,.568,67,91,.736,49,97,146,32,12,9,22,69,351
256,Shane Larkin\larkish01,PG,23,BRK,78,17,1751,222,502,.442,39,108,.361,183,394,.464,.481,83,107,.776,28,152,180,342,95,12,146,121,566
257,Joffrey Lauvergne\lauvejo01,C,24,DEN,59,15,1041,195,380,.513,13,53,.245,182,327,.557,.530,62,69,.899,77,213,290,56,13,15,54,115,465
258,Zach LaVine\lavinza01,SG,20,MIN,82,33,2294,433,959,.452,123,316,.389,310,643,.482,.516,161,203,.793,27,201,228,251,69,17,155,193,1150
259,Ty Lawson\lawsoty01,PG,28,TOT,66,13,1411,139,354,.393,36,108,.333,103,246,.419,.444,59,86,.686,26,94,120,237,53,7,95,87,373
259,Ty Lawson\lawsoty01,PG,28,HOU,53,12,1176,111,287,.387,31,94,.330,80,193,.415,.441,56,80,.700,20,69,89,180,43,6,82,71,309
259,Ty Lawson\lawsoty01,PG,28,IND,13,1,235,28,67,.418,5,14,.357,23,53,.434,.455,3,6,.500,6,25,31,57,10,1,13,16,64
260,Courtney Lee\leeco01,SG,30,TOT,79,65,2334,290,639,.454,82,217,.378,208,422,.493,.518,99,118,.839,29,176,205,136,85,28,72,134,761
260,Courtney Lee\leeco01,SG,30,MEM,51,37,1489,192,419,.458,51,138,.370,141,281,.502,.519,76,92,.826,19,99,118,76,52,16,49,79,511
260,Courtney Lee\leeco01,SG,30,CHO,28,28,845,98,220,.445,31,79,.392,67,141,.475,.516,23,26,.885,10,77,87,60,33,12,23,55,250
261,David Lee\leeda02,PF,32,TOT,55,5,903,178,335,.531,0,1,.000,178,334,.533,.531,71,93,.763,101,204,305,84,22,28,66,114,427
261,David Lee\leeda02,PF,32,BOS,30,4,470,87,192,.453,0,1,.000,87,191,.455,.453,40,51,.784,41,89,130,54,12,13,38,51,214
261,David Lee\leeda02,PF,32,DAL,25,1,433,91,143,.636,0,0,,91,143,.636,.636,31,42,.738,60,115,175,30,10,15,28,63,213
262,Alex Len\lenal01,C,22,PHO,78,46,1821,264,624,.423,1,7,.143,263,617,.426,.424,174,239,.728,178,416,594,97,38,62,145,230,703
263,Kawhi Leonard\leonaka01,SF,24,SAS,72,72,2380,551,1090,.506,129,291,.443,422,799,.528,.565,292,334,.874,95,398,493,186,128,71,105,133,1523
264,Meyers Leonard\leoname01,PF,23,POR,61,10,1333,195,435,.448,86,228,.377,109,207,.527,.547,35,46,.761,51,263,314,92,8,18,77,183,511
265,Jon Leuer\leuerjo01,PF,26,PHO,67,27,1255,224,466,.481,42,110,.382,182,356,.511,.526,77,101,.762,76,297,373,72,38,30,75,125,567
266,Damian Lillard\lillada01,PG,25,POR,75,75,2676,618,1474,.419,229,610,.375,389,864,.450,.497,414,464,.892,45,257,302,512,65,28,242,165,1879
267,Jeremy Lin\linje01,SG,27,CHO,78,13,2048,300,728,.412,76,226,.336,224,502,.446,.464,238,292,.815,42,211,253,235,58,42,150,165,914
268,Shaun Livingston\livinsh01,PG,30,GSW,78,3,1520,203,379,.536,2,12,.167,201,367,.548,.538,80,93,.860,42,127,169,237,57,27,78,140,488
269,Kevon Looney\looneke01,PF,19,GSW,5,0,21,4,7,.571,1,2,.500,3,5,.600,.643,0,0,,4,6,10,0,0,0,1,2,9
270,Brook Lopez\lopezbr01,C,27,BRK,73,73,2457,591,1157,.511,2,14,.143,589,1143,.515,.512,317,403,.787,204,369,573,147,58,124,175,215,1501
271,Robin Lopez\lopezro01,C,27,NYK,82,82,2219,357,662,.539,0,1,.000,357,661,.540,.539,128,161,.795,268,334,602,114,16,129,133,182,842
272,Kevin Love\loveke01,PF,27,CLE,77,77,2424,409,977,.419,158,439,.360,251,538,.467,.499,258,314,.822,149,613,762,186,58,41,142,159,1234
273,Kyle Lowry\lowryky01,PG,29,TOR,77,77,2851,512,1198,.427,212,547,.388,300,651,.461,.516,398,491,.811,55,310,365,494,158,34,225,211,1634
274,Trey Lyles\lylestr01,PF,20,UTA,80,33,1382,191,436,.438,49,128,.383,142,308,.461,.494,57,82,.695,59,240,299,59,26,18,65,114,488
275,Shelvin Mack\macksh01,PG,25,TOT,52,27,1058,182,415,.439,39,125,.312,143,290,.493,.486,45,61,.738,13,115,128,187,34,3,95,72,448
275,Shelvin Mack\macksh01,PG,25,ATL,24,0,179,40,95,.421,4,27,.148,36,68,.529,.442,9,12,.750,2,20,22,38,8,0,14,7,93
275,Shelvin Mack\macksh01,PG,25,UTA,28,27,879,142,320,.444,35,98,.357,107,222,.482,.498,36,49,.735,11,95,106,149,26,3,81,65,355
276,Ian Mahinmi\mahinia01,C,29,IND,71,71,1816,264,448,.589,0,0,,264,448,.589,.589,132,225,.587,138,369,507,104,65,75,100,220,660
277,Devyn Marble\marblde01,SG,23,ORL,28,0,249,21,71,.296,8,32,.250,13,39,.333,.352,10,24,.417,6,32,38,12,13,1,7,25,60
278,Boban Marjanovic\marjabo01,C,27,SAS,54,4,508,105,174,.603,0,0,,105,174,.603,.603,87,114,.763,73,121,194,21,12,23,29,54,297
279,Kendall Marshall\marshke01,PG,24,PHI,30,6,400,43,118,.364,16,49,.327,27,69,.391,.432,9,13,.692,2,26,28,73,16,2,43,30,111
280,Jarell Martin\martija01,PF,21,MEM,27,0,380,54,116,.466,0,2,.000,54,114,.474,.466,45,62,.726,39,47,86,15,8,7,19,58,153
281,Kevin Martin\martike02,SG,32,TOT,55,13,1095,156,419,.372,49,136,.360,107,283,.378,.431,153,172,.890,14,96,110,58,26,3,54,83,514
281,Kevin Martin\martike02,SG,32,MIN,39,12,834,126,334,.377,38,103,.369,88,231,.381,.434,125,142,.880,10,71,81,46,17,1,41,68,415
281,Kevin Martin\martike02,SG,32,SAS,16,1,261,30,85,.353,11,33,.333,19,52,.365,.418,28,30,.933,4,25,29,12,9,2,13,15,99
282,Wesley Matthews\matthwe02,SF,29,DAL,78,78,2644,331,854,.388,189,525,.360,142,329,.432,.498,126,146,.863,27,211,238,151,78,17,78,179,977
283,O.J. Mayo\mayooj01,SG,28,MIL,41,24,1090,119,321,.371,52,162,.321,67,159,.421,.452,31,40,.775,13,92,105,118,48,8,72,126,321
284,Luc Mbah a Moute\mbahalu01,PF,29,LAC,75,61,1274,94,207,.454,13,40,.325,81,167,.485,.486,30,57,.526,60,111,171,30,44,19,34,100,231
285,James Michael McAdoo\mcadoja01,PF,23,GSW,41,1,262,45,84,.536,1,2,.500,44,82,.537,.542,26,49,.531,30,28,58,17,10,8,16,39,117
286,Ray McCallum\mccalra01,PG,24,TOT,41,6,475,55,146,.377,15,42,.357,40,104,.385,.428,12,15,.800,8,39,47,60,12,7,24,29,137
286,Ray McCallum\mccalra01,PG,24,SAS,31,3,256,27,67,.403,5,16,.313,22,51,.431,.440,9,10,.900,6,25,31,33,5,4,11,14,68
286,Ray McCallum\mccalra01,PG,24,MEM,10,3,219,28,79,.354,10,26,.385,18,53,.340,.418,3,5,.600,2,14,16,27,7,3,13,15,69
287,CJ McCollum\mccolcj01,SG,24,POR,80,80,2780,641,1431,.448,197,472,.417,444,959,.463,.517,187,226,.827,47,212,259,341,97,23,196,187,1666
288,T.J. McConnell\mccontj01,PG,23,PHI,81,17,1606,218,464,.470,31,89,.348,187,375,.499,.503,26,41,.634,43,207,250,367,95,10,140,114,493
289,Chris McCullough\mcculch01,PF,20,BRK,24,4,362,44,109,.404,13,34,.382,31,75,.413,.463,11,23,.478,25,43,68,9,28,12,15,39,112
290,K.J. McDaniels\mcdankj01,SF,22,HOU,37,1,235,29,72,.403,7,25,.280,22,47,.468,.451,24,30,.800,16,26,42,10,7,6,17,30,89
291,Doug McDermott\mcderdo01,SF,24,CHI,81,4,1861,291,644,.452,110,259,.425,181,385,.470,.537,72,84,.857,37,158,195,59,14,6,53,127,764
292,Mitch McGary\mcgarmi01,PF,23,OKC,20,0,72,11,23,.478,0,4,.000,11,19,.579,.478,4,10,.400,4,14,18,3,1,2,7,10,26
293,JaVale McGee\mcgeeja01,C,28,DAL,34,2,370,77,134,.575,0,1,.000,77,133,.579,.575,18,36,.500,53,80,133,3,5,26,21,49,172
294,Ben McLemore\mclembe01,SG,22,SAC,68,53,1443,195,455,.429,67,185,.362,128,270,.474,.502,74,103,.718,34,114,148,79,52,10,99,140,531
295,Jordan McRae\mcraejo01,PG,24,TOT,22,1,195,34,78,.436,10,22,.455,24,56,.429,.500,21,28,.750,4,16,20,25,3,1,15,17,99
295,Jordan McRae\mcraejo01,PG,24,PHO,7,0,82,11,26,.423,3,11,.273,8,15,.533,.481,12,15,.800,2,6,8,10,3,0,6,7,37
295,Jordan McRae\mcraejo01,PG,24,CLE,15,1,113,23,52,.442,7,11,.636,16,41,.390,.510,9,13,.692,2,10,12,15,0,1,9,10,62
296,Josh McRoberts\mcrobjo01,PF,28,MIA,42,1,595,55,148,.372,12,49,.245,43,99,.434,.412,28,40,.700,22,83,105,81,18,7,30,68,150
297,Jodie Meeks\meeksjo01,SG,28,DET,3,0,43,7,20,.350,4,9,.444,3,11,.273,.450,4,4,1.000,1,4,5,3,0,0,1,2,22
298,Salah Mejri\mejrisa01,C,29,DAL,34,6,397,49,78,.628,0,1,.000,49,77,.636,.628,27,46,.587,41,82,123,10,8,36,23,54,125
299,Jordan Mickey\mickejo01,PF,21,BOS,16,0,57,8,22,.364,0,0,,8,22,.364,.364,5,10,.500,6,7,13,1,0,11,1,5,21
300,Khris Middleton\middlkh01,SG,24,MIL,79,79,2852,507,1142,.444,143,361,.396,364,781,.466,.507,277,312,.888,44,258,302,331,131,19,180,204,1434
301,C.J. Miles\milescj01,SF,28,IND,64,24,1464,259,634,.409,142,387,.367,117,247,.474,.521,93,124,.750,25,150,175,63,53,29,70,142,753
302,Andre Miller\millean02,PG,39,TOT,39,4,461,59,106,.557,2,8,.250,57,98,.582,.566,24,32,.750,12,39,51,87,16,0,37,46,144
302,Andre Miller\millean02,PG,39,MIN,26,0,280,36,58,.621,1,4,.250,35,54,.648,.629,15,19,.789,6,18,24,58,9,0,25,32,88
302,Andre Miller\millean02,PG,39,SAS,13,4,181,23,48,.479,1,4,.250,22,44,.500,.490,9,13,.692,6,21,27,29,7,0,12,14,56
303,Mike Miller\millemi01,SF,35,DEN,47,2,373,22,62,.355,19,52,.365,3,10,.300,.508,0,0,,6,47,53,40,13,4,17,53,63
304,Patty Mills\millspa02,PG,27,SAS,81,3,1662,260,612,.425,123,320,.384,137,292,.469,.525,47,58,.810,27,131,158,226,59,6,76,102,690
305,Elijah Millsap\millsel01,SG,28,UTA,20,0,173,11,39,.282,1,12,.083,10,27,.370,.295,13,18,.722,6,29,35,19,7,3,9,33,36
306,Paul Millsap\millspa01,PF,30,ATL,81,81,2647,501,1066,.470,74,232,.319,427,834,.512,.505,309,408,.757,198,534,732,265,147,139,191,237,1385
307,Nikola Mirotic\mirotni01,PF,24,CHI,66,38,1646,248,609,.407,135,346,.390,113,263,.430,.518,146,181,.807,58,304,362,100,58,46,102,151,777
308,Nazr Mohammed\mohamna01,C,38,OKC,5,0,19,3,5,.600,0,0,,3,5,.600,.600,2,2,1.000,1,3,4,0,0,0,3,4,8
309,Greg Monroe\monrogr01,C,25,MIL,79,67,2314,491,941,.522,0,1,.000,491,940,.522,.522,228,308,.740,218,478,696,178,72,67,129,163,1210
310,Luis Montero\montelu01,SG,22,POR,12,0,42,5,19,.263,1,9,.111,4,10,.400,.289,3,4,.750,0,4,4,1,0,0,4,1,14
311,E'Twaun Moore\mooreet01,SG,26,CHI,59,22,1263,187,389,.481,47,104,.452,140,285,.491,.541,22,35,.629,19,114,133,99,37,18,53,103,443
312,Eric Moreland\moreler01,PF,24,SAC,8,0,48,3,6,.500,0,0,,3,6,.500,.500,2,4,.500,3,8,11,1,0,4,3,4,8
313,Marcus Morris\morrima03,SF,26,DET,80,80,2856,410,945,.434,108,298,.362,302,647,.467,.491,203,271,.749,91,313,404,201,67,23,140,170,1131
314,Markieff Morris\morrima02,PF,26,TOT,64,45,1629,305,718,.425,47,155,.303,258,563,.458,.458,108,147,.735,73,279,352,124,58,34,135,184,765
314,Markieff Morris\morrima02,PF,26,PHO,37,24,917,171,431,.397,22,76,.289,149,355,.420,.422,66,92,.717,43,151,194,87,33,17,90,104,430
314,Markieff Morris\morrima02,PF,26,WAS,27,21,712,134,287,.467,25,79,.316,109,208,.524,.510,42,55,.764,30,128,158,37,25,17,45,80,335
315,Anthony Morrow\morroan01,SG,30,OKC,68,6,926,136,333,.408,79,204,.387,57,129,.442,.527,29,39,.744,10,52,62,24,22,5,17,64,380
316,Donatas Motiejunas\motiedo01,PF,25,HOU,37,22,547,90,205,.439,16,57,.281,74,148,.500,.478,34,53,.642,37,72,109,41,17,5,44,69,230
317,Timofey Mozgov\mozgoti01,C,29,CLE,76,48,1326,203,359,.565,1,7,.143,202,352,.574,.567,68,95,.716,110,227,337,33,22,57,71,159,475
318,Emmanuel Mudiay\mudiaem01,PG,19,DEN,68,66,2068,329,905,.364,74,232,.319,255,673,.379,.404,140,209,.670,32,200,232,372,65,35,217,141,872
319,Shabazz Muhammad\muhamsh01,SF,23,MIN,82,0,1682,317,681,.465,44,152,.289,273,529,.516,.498,185,242,.764,100,167,267,52,24,7,70,94,863
320,Xavier Munford\munfoxa02,SG,23,MEM,14,0,244,32,77,.416,9,23,.391,23,54,.426,.474,7,14,.500,3,28,31,22,13,3,15,25,80
321,Mike Muscala\muscami01,C,24,ATL,60,0,565,76,152,.500,12,39,.308,64,113,.566,.539,31,39,.795,38,79,117,34,13,27,27,72,195
322,Larry Nance\nancela02,PF,23,LAL,63,22,1266,158,300,.527,1,10,.100,157,290,.541,.528,32,47,.681,101,211,312,44,54,23,41,124,349
323,Shabazz Napier\napiesh01,PG,24,ORL,55,0,600,68,201,.338,34,104,.327,34,97,.351,.423,33,45,.733,9,46,55,97,23,1,46,38,203
324,Gary Neal\nealga01,SG,31,WAS,40,2,807,151,325,.465,41,100,.410,110,225,.489,.528,47,55,.855,11,72,83,47,20,1,29,55,390
325,Jameer Nelson\nelsoja01,PG,33,DEN,39,15,1036,113,307,.368,43,144,.299,70,163,.429,.438,30,35,.857,19,96,115,190,25,5,66,100,299
326,Raul Neto\netora01,PG,23,UTA,81,53,1499,180,418,.431,64,162,.395,116,256,.453,.507,52,70,.743,17,103,120,174,62,2,109,122,476
327,Andrew Nicholson\nichoan01,PF,26,ORL,56,0,823,146,310,.471,41,114,.360,105,196,.536,.537,51,65,.785,34,167,201,25,10,22,41,69,384
328,Joakim Noah\noahjo01,C,30,CHI,29,2,635,51,133,.383,0,1,.000,51,132,.386,.383,22,45,.489,87,168,255,110,18,29,52,77,124
329,Nerlens Noel\noelne01,C,21,PHI,67,62,1965,306,587,.521,1,2,.500,305,585,.521,.522,134,227,.590,154,388,542,122,118,100,158,192,747
330,Lucas Nogueira\noguelu01,C,23,TOR,29,1,225,28,44,.636,1,3,.333,27,41,.659,.648,8,15,.533,18,28,46,7,12,12,11,29,65
331,Steve Novak\novakst01,PF,32,TOT,10,0,44,8,18,.444,7,15,.467,1,3,.333,.639,1,1,1.000,0,5,5,0,0,0,1,3,24
331,Steve Novak\novakst01,PF,32,OKC,7,0,24,6,12,.500,5,9,.556,1,3,.333,.708,0,0,,0,4,4,0,0,0,1,1,17
331,Steve Novak\novakst01,PF,32,MIL,3,0,20,2,6,.333,2,6,.333,0,0,,.500,1,1,1.000,0,1,1,0,0,0,0,2,7
332,Dirk Nowitzki\nowitdi01,PF,37,DAL,75,75,2364,498,1112,.448,126,342,.368,372,770,.483,.504,250,280,.893,52,437,489,132,52,52,84,161,1372
333,Jusuf Nurkic\nurkiju01,C,21,DEN,32,3,547,101,242,.417,0,3,.000,101,239,.423,.417,61,99,.616,65,110,175,40,24,44,55,91,263
334,J.J. O'Brien\obriejj01,SF,23,UTA,2,0,6,0,1,.000,0,0,,0,1,.000,.000,0,0,,0,1,1,0,1,0,0,1,0
335,Johnny O'Bryant\obryajo01,PF,22,MIL,66,4,857,86,209,.411,1,1,1.000,85,208,.409,.414,27,40,.675,65,111,176,32,18,8,31,100,200
336,Kyle O'Quinn\oquinky01,PF,25,NYK,65,1,764,129,271,.476,5,22,.227,124,249,.498,.485,46,60,.767,76,174,250,72,20,49,61,107,309
337,Jahlil Okafor\okafoja01,C,20,PHI,53,48,1591,397,781,.508,1,6,.167,396,775,.511,.509,133,194,.686,122,251,373,65,22,61,124,140,928
338,Victor Oladipo\oladivi01,SG,23,ORL,72,52,2379,425,970,.438,98,282,.348,327,688,.475,.489,205,247,.830,48,297,345,282,116,54,153,174,1153
339,Kelly Olynyk\olynyke01,C,24,BOS,69,8,1395,253,556,.455,85,210,.405,168,346,.486,.531,96,128,.750,72,209,281,105,52,33,74,163,687
340,Kelly Oubre\oubreke01,SF,20,WAS,63,9,671,90,211,.427,25,79,.316,65,132,.492,.486,31,49,.633,25,108,133,13,22,7,34,100,236
341,Zaza Pachulia\pachuza01,C,31,DAL,76,69,2004,219,470,.466,0,3,.000,219,467,.469,.466,212,276,.768,249,469,718,128,64,22,119,181,650
342,Kostas Papanikolaou\papanko01,SF,25,DEN,26,6,294,24,66,.364,10,32,.313,14,34,.412,.439,9,14,.643,8,32,40,16,13,5,21,24,67
343,Jabari Parker\parkeja01,PF,20,MIL,76,72,2408,443,899,.493,9,35,.257,434,864,.502,.498,175,228,.768,123,272,395,130,69,29,116,154,1070
344,Tony Parker\parketo01,PG,33,SAS,72,72,1980,350,710,.493,27,65,.415,323,645,.501,.512,130,171,.760,17,159,176,379,54,11,131,114,857
345,Chandler Parsons\parsoch01,SF,27,DAL,61,51,1799,320,651,.492,104,251,.414,216,400,.540,.571,93,136,.684,29,256,285,169,46,21,95,114,837
346,Lamar Patterson\pattela01,SG,24,ATL,35,0,395,28,80,.350,12,49,.245,16,31,.516,.425,16,22,.727,4,46,50,39,9,2,23,45,84
347,Patrick Patterson\pattepa01,PF,26,TOR,79,0,2020,204,493,.414,106,293,.362,98,200,.490,.521,29,34,.853,77,265,342,94,53,32,65,128,543
348,Chris Paul\paulch01,PG,30,LAC,74,74,2420,515,1114,.462,122,329,.371,393,785,.501,.517,294,328,.896,39,271,310,738,152,13,194,185,1446
349,Adreian Payne\paynead01,PF,24,MIN,52,2,486,53,145,.366,9,32,.281,44,113,.389,.397,17,26,.654,20,91,111,29,16,11,36,77,132
350,Cameron Payne\payneca01,PG,21,OKC,57,1,698,114,278,.410,36,111,.324,78,167,.467,.475,19,24,.792,9,76,85,108,36,6,44,80,283
351,Elfrid Payton\paytoel01,PG,21,ORL,73,69,2145,318,730,.436,30,92,.326,288,638,.451,.456,112,190,.589,77,184,261,468,89,20,177,159,778
352,Nikola Pekovic\pekovni01,C,30,MIN,12,3,156,19,50,.380,0,0,,19,50,.380,.380,16,20,.800,7,14,21,11,1,0,9,22,54
353,Kendrick Perkins\perkike01,C,31,NOP,37,5,542,40,75,.533,0,0,,40,75,.533,.533,11,25,.440,25,103,128,31,11,11,41,64,91
354,Paul Pierce\piercpa01,SF,38,LAC,68,38,1231,144,397,.363,75,242,.310,69,155,.445,.457,54,66,.818,12,174,186,71,33,17,58,129,417
355,Tibor Pleiss\pleisti01,C,26,UTA,12,0,82,11,25,.440,0,2,.000,11,23,.478,.440,2,2,1.000,6,9,15,2,1,2,8,19,24
356,Mason Plumlee\plumlma01,C,25,POR,82,82,2084,267,517,.516,0,4,.000,267,513,.520,.516,215,335,.642,201,427,628,226,68,85,154,253,749
357,Miles Plumlee\plumlmi01,C,27,MIL,61,14,870,140,233,.601,0,0,,140,233,.601,.601,34,59,.576,94,138,232,16,21,50,40,73,314
358,Otto Porter\porteot01,SF,22,WAS,75,73,2276,339,717,.473,98,267,.367,241,450,.536,.541,95,126,.754,97,294,391,120,105,32,70,163,871
359,Bobby Portis\portibo01,PF,20,CHI,62,4,1102,186,436,.427,16,52,.308,170,384,.443,.445,48,66,.727,123,214,337,52,25,22,54,100,436
360,Kristaps Porzingis\porzikr01,PF,20,NYK,72,72,2047,373,886,.421,81,243,.333,292,643,.454,.467,201,240,.838,132,394,526,94,53,134,121,205,1028
361,Dwight Powell\poweldw01,PF,24,DAL,69,2,992,146,296,.493,2,16,.125,144,280,.514,.497,105,142,.739,84,189,273,44,36,24,40,118,399
362,Norman Powell\powelno01,SG,22,TOR,49,24,725,97,229,.424,36,89,.404,61,140,.436,.502,43,53,.811,16,95,111,47,29,10,32,59,273
363,Phil Pressey\pressph01,PG,24,TOT,23,0,283,30,78,.385,4,18,.222,26,60,.433,.410,13,25,.520,3,28,31,75,18,4,33,28,77
363,Phil Pressey\pressph01,PG,24,PHI,14,0,170,21,55,.382,4,13,.308,17,42,.405,.418,9,18,.500,0,23,23,46,11,1,19,14,55
363,Phil Pressey\pressph01,PG,24,PHO,9,0,113,9,23,.391,0,5,.000,9,18,.500,.391,4,7,.571,3,5,8,29,7,3,14,14,22
364,Ronnie Price\pricero01,PG,32,PHO,62,18,1211,116,302,.384,68,196,.347,48,106,.453,.497,31,41,.756,25,74,99,147,74,13,70,161,331
365,Pablo Prigioni\prigipa01,PG,38,LAC,59,3,823,55,147,.374,28,95,.295,27,52,.519,.469,7,8,.875,38,76,114,130,53,1,49,82,145
366,Tayshaun Prince\princta01,SF,35,MIN,77,44,1462,102,229,.445,4,23,.174,98,206,.476,.454,13,19,.684,32,115,147,73,36,13,27,62,221
367,Julius Randle\randlju01,PF,21,LAL,81,60,2286,358,835,.429,10,36,.278,348,799,.436,.435,193,270,.715,172,657,829,144,53,29,149,242,919
368,Zach Randolph\randoza01,PF,34,MEM,68,53,2016,431,907,.475,6,26,.231,425,881,.482,.479,172,216,.796,179,350,529,142,43,13,105,146,1040
369,J.J. Redick\redicjj01,SG,31,LAC,75,75,2097,422,880,.480,200,421,.475,222,459,.484,.593,182,205,.888,10,129,139,106,42,5,78,135,1226
370,Willie Reed\reedwi02,C,25,BRK,39,2,426,76,133,.571,0,0,,76,133,.571,.571,30,55,.545,49,73,122,10,6,30,16,47,182
371,Josh Richardson\richajo01,SG,22,MIA,52,2,1107,123,272,.452,53,115,.461,70,157,.446,.550,42,63,.667,21,86,107,73,36,25,35,107,341
372,Austin Rivers\riverau01,SG,23,LAC,67,7,1464,226,516,.438,62,185,.335,164,331,.495,.498,79,116,.681,22,108,130,99,48,9,61,137,593
373,Andre Roberson\roberan03,SG,24,OKC,70,70,1553,136,274,.496,32,103,.311,104,171,.608,.555,33,54,.611,79,172,251,47,53,42,35,133,337
374,Brian Roberts\roberbr01,PG,30,TOT,51,0,470,74,165,.448,15,42,.357,59,123,.480,.494,42,47,.894,6,35,41,54,10,2,23,35,205
374,Brian Roberts\roberbr01,PG,30,CHO,30,0,333,51,115,.443,9,27,.333,42,88,.477,.483,34,37,.919,4,25,29,38,7,1,16,23,145
374,Brian Roberts\roberbr01,PG,30,POR,21,0,137,23,50,.460,6,15,.400,17,35,.486,.520,8,10,.800,2,10,12,16,3,1,7,12,60
375,Glenn Robinson\robingl02,SF,22,IND,45,4,508,65,151,.430,14,37,.378,51,114,.447,.477,27,39,.692,12,56,68,26,17,9,18,21,171
376,Nate Robinson\robinna01,PG,31,NOP,2,1,23,0,1,.000,0,1,.000,0,0,,.000,0,0,,0,0,0,4,1,0,0,5,0
377,Thomas Robinson\robinth01,PF,24,BRK,71,7,917,130,291,.447,0,1,.000,130,290,.448,.447,47,109,.431,136,223,359,46,39,36,69,111,307
378,Rajon Rondo\rondora01,PG,29,SAC,72,72,2537,355,782,.454,62,170,.365,293,612,.479,.494,87,150,.580,77,358,435,839,141,10,278,175,859
379,Derrick Rose\rosede01,PG,27,CHI,66,66,2097,447,1048,.427,44,150,.293,403,898,.449,.448,142,179,.793,46,179,225,311,44,14,175,84,1080
380,Terrence Ross\rosste01,SF,24,TOR,73,7,1747,270,626,.431,131,339,.386,139,287,.484,.536,49,62,.790,21,164,185,56,54,25,46,120,720
381,Terry Rozier\roziete01,PG,21,BOS,39,0,311,29,106,.274,6,27,.222,23,79,.291,.302,8,10,.800,24,39,63,37,6,1,19,23,72
382,Ricky Rubio\rubiori01,PG,25,MIN,76,76,2323,219,586,.374,62,190,.326,157,396,.396,.427,266,314,.847,40,286,326,658,162,10,193,201,766
383,Damjan Rudez\rudezda01,SF,29,MIN,33,0,277,25,62,.403,17,50,.340,8,12,.667,.540,8,8,1.000,5,15,20,11,3,1,13,33,75
384,Brandon Rush\rushbr01,SG,30,GSW,72,25,1055,111,260,.427,65,157,.414,46,103,.447,.552,18,28,.643,21,160,181,57,20,23,33,57,305
385,D'Angelo Russell\russeda01,PG,19,LAL,80,48,2259,392,956,.410,130,370,.351,262,586,.447,.478,140,190,.737,47,227,274,266,93,13,196,142,1054
386,Robert Sacre\sacrero01,C,26,LAL,25,1,320,31,75,.413,0,0,,31,75,.413,.413,25,38,.658,32,40,72,14,4,10,12,43,87
387,JaKarr Sampson\sampsja02,SF,22,TOT,73,40,1160,140,317,.442,14,63,.222,126,254,.496,.464,80,122,.656,46,144,190,46,23,33,70,142,374
387,JaKarr Sampson\sampsja02,SF,22,PHI,47,18,691,86,202,.426,6,34,.176,80,168,.476,.441,62,97,.639,30,99,129,30,11,16,51,91,240
387,JaKarr Sampson\sampsja02,SF,22,DEN,26,22,469,54,115,.470,8,29,.276,46,86,.535,.504,18,25,.720,16,45,61,16,12,17,19,51,134
388,Dennis Schroder\schrode01,PG,22,ATL,80,6,1621,329,781,.421,77,239,.322,252,542,.465,.471,144,182,.791,25,179,204,349,70,9,183,138,879
389,Luis Scola\scolalu01,PF,35,TOR,76,76,1636,269,598,.450,65,161,.404,204,437,.467,.504,61,84,.726,84,276,360,66,46,27,68,178,664
390,Mike Scott\scottmi01,PF,27,ATL,75,0,1146,176,376,.468,62,158,.392,114,218,.523,.551,50,63,.794,53,153,206,78,25,17,42,102,464
391,Thabo Sefolosha\sefolth01,SF,31,ATL,75,11,1758,188,372,.505,42,124,.339,146,248,.589,.562,62,99,.626,52,282,334,107,85,37,68,109,480
392,Kevin Seraphin\serapke01,C,26,NYK,48,0,526,84,205,.410,0,2,.000,84,203,.414,.410,19,23,.826,31,95,126,47,8,36,43,67,187
393,Ramon Sessions\sessira01,PG,29,WAS,82,5,1667,280,592,.473,36,111,.324,244,481,.507,.503,214,283,.756,25,178,203,239,46,5,115,102,810
394,Iman Shumpert\shumpim01,SG,25,CLE,54,5,1316,114,305,.374,43,146,.295,71,159,.447,.444,40,51,.784,32,171,203,92,54,19,57,119,311
395,Jonathon Simmons\simmojo02,SG,26,SAS,55,2,813,122,242,.504,18,47,.383,104,195,.533,.541,69,92,.750,16,80,96,58,24,5,53,103,331
396,Henry Sims\simshe01,C,25,BRK,14,4,263,33,77,.429,0,0,,33,77,.429,.429,25,30,.833,21,51,72,9,9,14,12,37,91
397,Kyle Singler\singlky01,SF,27,OKC,68,2,977,86,221,.389,30,97,.309,56,124,.452,.457,29,44,.659,50,91,141,24,30,9,32,120,231
398,Donald Sloan\sloando01,PG,28,BRK,61,33,1318,154,350,.440,38,99,.384,116,251,.462,.494,78,104,.750,17,156,173,268,32,4,80,73,424
399,Marcus Smart\smartma01,PG,21,BOS,61,10,1667,184,529,.348,61,241,.253,123,288,.427,.405,129,166,.777,76,179,255,185,91,18,80,183,558
400,Greg Smith\smithgr02,PF,25,MIN,18,0,192,18,32,.563,0,0,,18,32,.563,.563,7,17,.412,12,30,42,6,4,1,7,28,43
401,Ish Smith\smithis01,PG,27,TOT,77,53,2239,397,967,.411,56,170,.329,341,797,.428,.440,122,176,.693,43,262,305,502,88,24,175,133,972
401,Ish Smith\smithis01,PG,27,NOP,27,3,617,98,228,.430,10,33,.303,88,195,.451,.452,33,43,.767,14,78,92,154,24,6,45,38,239
401,Ish Smith\smithis01,PG,27,PHI,50,50,1622,299,739,.405,46,137,.336,253,602,.420,.436,89,133,.669,29,184,213,348,64,18,130,95,733
402,J.R. Smith\smithjr01,SG,30,CLE,77,77,2362,353,850,.415,204,510,.400,149,340,.438,.535,45,71,.634,43,174,217,130,81,21,59,204,955
403,Jason Smith\smithja02,C,29,ORL,76,2,1181,244,503,.485,4,16,.250,240,487,.493,.489,54,67,.806,53,166,219,62,33,65,57,163,546
404,Josh Smith\smithjo03,PF,30,TOT,55,7,880,127,349,.364,41,143,.287,86,206,.417,.423,37,67,.552,51,141,192,90,34,47,77,118,332
404,Josh Smith\smithjo03,PF,30,LAC,32,1,459,69,180,.383,18,58,.310,51,122,.418,.433,25,42,.595,33,92,125,42,18,34,41,62,181
404,Josh Smith\smithjo03,PF,30,HOU,23,6,421,58,169,.343,23,85,.271,35,84,.417,.411,12,25,.480,18,49,67,48,16,13,36,56,151
405,Russ Smith\smithru01,PG,24,MEM,15,0,66,7,22,.318,1,5,.200,6,17,.353,.341,8,13,.615,1,8,9,11,5,1,7,5,23
406,Tony Snell\snellto01,SF,24,CHI,64,33,1301,126,339,.372,56,155,.361,70,184,.380,.454,30,33,.909,19,180,199,63,16,17,52,100,338
407,Marreese Speights\speigma01,C,28,GSW,72,0,832,197,456,.432,24,62,.387,173,394,.439,.458,94,114,.825,77,162,239,61,19,34,66,117,512
408,Tiago Splitter\splitti01,C,31,ATL,36,2,579,81,155,.523,0,2,.000,81,153,.529,.523,39,48,.813,45,75,120,30,20,12,24,71,201
409,Nik Stauskas\stausni01,SG,22,PHI,73,35,1809,210,545,.385,106,325,.326,104,220,.473,.483,91,118,.771,23,160,183,138,44,20,94,115,617
410,Lance Stephenson\stephla01,SF,25,TOT,69,13,1372,228,474,.481,30,78,.385,198,396,.500,.513,87,111,.784,40,183,223,133,43,9,94,135,573
410,Lance Stephenson\stephla01,SF,25,LAC,43,10,680,82,166,.494,19,47,.404,63,119,.529,.551,21,30,.700,19,89,108,60,24,3,48,79,204
410,Lance Stephenson\stephla01,SF,25,MEM,26,3,692,146,308,.474,11,31,.355,135,277,.487,.492,66,81,.815,21,94,115,73,19,6,46,56,369
411,Alex Stepheson\stephal01,PF,28,TOT,8,0,73,9,27,.333,0,0,,9,27,.333,.333,4,12,.333,19,9,28,2,1,5,0,12,22
411,Alex Stepheson\stephal01,PF,28,LAC,4,0,12,1,1,1.000,0,0,,1,1,1.000,1.000,0,2,.000,1,1,2,0,0,2,0,4,2
411,Alex Stepheson\stephal01,PF,28,MEM,4,0,61,8,26,.308,0,0,,8,26,.308,.308,4,10,.400,18,8,26,2,1,3,0,8,20
412,Jarnell Stokes\stokeja01,C,22,TOT,7,0,18,3,5,.600,0,0,,3,5,.600,.600,1,2,.500,1,3,4,1,1,0,0,1,7
412,Jarnell Stokes\stokeja01,C,22,MEM,2,0,4,0,0,,0,0,,0,0,,,0,0,,1,1,2,0,0,0,0,0,0
412,Jarnell Stokes\stokeja01,C,22,MIA,5,0,14,3,5,.600,0,0,,3,5,.600,.600,1,2,.500,0,2,2,1,1,0,0,1,7
413,Amar'e Stoudemire\stoudam01,C,33,MIA,52,36,762,125,221,.566,0,0,,125,221,.566,.566,50,67,.746,65,157,222,27,18,41,47,92,300
414,Rodney Stuckey\stuckro01,PG,29,IND,58,1,1275,183,443,.413,20,83,.241,163,360,.453,.436,131,158,.829,19,137,156,142,43,8,76,77,517
415,Jared Sullinger\sullija01,PF,23,BOS,81,73,1915,351,806,.435,29,103,.282,322,703,.458,.453,103,161,.640,194,479,673,187,75,47,102,209,834
416,Edy Tavares\tavarwa01,C,23,ATL,11,0,73,11,19,.579,0,0,,11,19,.579,.579,3,8,.375,7,14,21,3,1,6,5,8,25
417,Jeff Teague\teaguje01,PG,27,ATL,79,78,2255,434,988,.439,110,275,.400,324,713,.454,.495,261,312,.837,33,181,214,470,97,24,218,167,1239
418,Mirza Teletovic\teletmi01,PF,30,PHO,79,1,1686,332,777,.427,181,460,.393,151,317,.476,.544,120,155,.774,55,247,302,89,32,21,84,159,965
419,Garrett Temple\templga01,SF,29,WAS,80,43,1951,201,505,.398,89,258,.345,112,247,.453,.486,91,125,.728,36,176,212,140,69,18,64,195,582
420,Jason Terry\terryja01,SG,38,HOU,72,7,1258,151,376,.402,93,261,.356,58,115,.504,.525,27,33,.818,14,65,79,103,47,9,49,91,422
421,Isaiah Thomas\thomais02,PG,26,BOS,82,79,2644,591,1382,.428,167,465,.359,424,917,.462,.488,474,544,.871,46,197,243,509,91,9,220,167,1823
422,Lance Thomas\thomala01,PF,27,NYK,59,5,1313,169,382,.442,44,109,.404,125,273,.458,.500,102,119,.857,34,97,131,53,22,7,57,109,484
423,Hollis Thompson\thompho01,SG,24,PHI,77,17,2154,270,680,.397,149,392,.380,121,288,.420,.507,69,96,.719,54,218,272,99,36,24,76,187,758
424,Jason Thompson\thompja02,C,29,TOT,47,7,471,52,108,.481,5,15,.333,47,93,.505,.505,38,54,.704,32,102,134,29,12,20,15,80,147
424,Jason Thompson\thompja02,C,29,GSW,28,1,179,20,42,.476,0,0,,20,42,.476,.476,20,32,.625,10,44,54,19,4,8,7,40,60
424,Jason Thompson\thompja02,C,29,TOR,19,6,292,32,66,.485,5,15,.333,27,51,.529,.523,18,22,.818,22,58,80,10,8,12,8,40,87
425,Klay Thompson\thompkl01,SG,25,GSW,80,80,2666,651,1386,.470,276,650,.425,375,736,.510,.569,193,221,.873,35,271,306,166,60,49,138,152,1771
426,Tristan Thompson\thomptr01,PF,24,CLE,82,34,2269,247,420,.588,0,0,,247,420,.588,.588,149,242,.616,268,470,738,62,38,51,61,202,643
427,Marcus Thornton\thornma01,SG,28,TOT,61,8,1109,216,542,.399,91,270,.337,125,272,.460,.482,67,79,.848,38,112,150,85,47,4,51,90,590
427,Marcus Thornton\thornma01,SG,28,HOU,47,6,885,174,435,.400,73,216,.338,101,219,.461,.484,51,58,.879,31,84,115,66,34,3,40,73,472
427,Marcus Thornton\thornma01,SG,28,WAS,14,2,224,42,107,.393,18,54,.333,24,53,.453,.477,16,21,.762,7,28,35,19,13,1,11,17,118
428,Anthony Tolliver\tollian01,PF,30,DET,72,5,1341,128,332,.386,98,272,.360,30,60,.500,.533,29,47,.617,39,190,229,52,26,16,28,86,383
429,Axel Toupane\toupaax01,SF,23,DEN,21,0,305,25,70,.357,13,40,.325,12,30,.400,.450,13,17,.765,8,23,31,15,7,6,6,40,76
430,Karl-Anthony Towns\townska01,C,20,MIN,82,82,2627,625,1153,.542,30,88,.341,595,1065,.559,.555,223,275,.811,229,629,858,161,58,138,183,245,1503
431,P.J. Tucker\tuckepj01,SF,30,PHO,82,80,2540,239,582,.411,68,206,.330,171,376,.455,.469,106,142,.746,165,347,512,177,106,20,111,202,652
432,Evan Turner\turneev01,SG,27,BOS,81,12,2271,343,753,.456,20,83,.241,323,670,.482,.469,148,179,.827,50,347,397,359,80,28,169,139,854
433,Myles Turner\turnemy01,C,19,IND,60,30,1367,264,530,.498,3,14,.214,261,516,.506,.501,88,121,.727,68,264,332,41,25,86,67,158,619
434,Beno Udrih\udrihbe01,PG,33,TOT,44,5,707,86,198,.434,15,44,.341,71,154,.461,.472,18,20,.900,8,64,72,116,14,1,53,51,205
434,Beno Udrih\udrihbe01,PG,33,MEM,8,0,120,20,46,.435,4,11,.364,16,35,.457,.478,3,3,1.000,2,7,9,26,3,1,11,11,47
434,Beno Udrih\udrihbe01,PG,33,MIA,36,5,587,66,152,.434,11,33,.333,55,119,.462,.470,15,17,.882,6,57,63,90,11,0,42,40,158
435,Jonas Valanciunas\valanjo01,C,23,TOR,60,59,1557,303,536,.565,0,0,,303,536,.565,.565,162,213,.761,184,363,547,42,25,80,85,158,768
436,Anderson Varejao\varejan01,C,33,TOT,53,0,496,53,124,.427,0,1,.000,53,123,.431,.427,32,50,.640,37,104,141,35,16,10,22,70,138
436,Anderson Varejao\varejan01,C,33,CLE,31,0,310,32,76,.421,0,1,.000,32,75,.427,.421,16,21,.762,24,67,91,20,11,5,16,35,80
436,Anderson Varejao\varejan01,C,33,GSW,22,0,186,21,48,.438,0,0,,21,48,.438,.438,16,29,.552,13,37,50,15,5,5,6,35,58
437,Greivis Vasquez\vasqugr01,PG,29,MIL,23,0,460,45,138,.326,18,73,.247,27,65,.415,.391,22,26,.846,5,42,47,91,10,0,40,42,130
438,Rashad Vaughn\vaughra01,SG,19,MIL,70,6,1001,81,266,.305,43,147,.293,38,119,.319,.385,12,15,.800,11,77,88,39,29,16,28,73,217
439,Charlie Villanueva\villach01,PF,31,DAL,62,4,665,125,327,.382,47,172,.273,78,155,.503,.454,22,24,.917,24,128,152,24,18,15,31,71,319
440,Noah Vonleh\vonleno01,PF,20,POR,78,56,1174,117,278,.421,11,46,.239,106,232,.457,.441,38,51,.745,91,214,305,30,27,26,50,152,283
441,Nikola Vucevic\vucevni01,C,25,ORL,65,60,2037,533,1046,.510,2,9,.222,531,1037,.512,.511,113,150,.753,174,402,576,179,53,70,123,173,1181
442,Sasha Vujacic\vujacsa01,SG,31,NYK,61,25,908,106,277,.383,52,143,.364,54,134,.403,.477,32,39,.821,26,123,149,84,34,5,44,83,296
443,Dwyane Wade\wadedw01,SG,34,MIA,74,73,2258,540,1183,.456,7,44,.159,533,1139,.468,.459,322,406,.793,82,220,302,344,79,42,203,116,1409
444,Dion Waiters\waitedi01,SG,24,OKC,78,15,2152,282,706,.399,86,240,.358,196,466,.421,.460,112,157,.713,36,166,202,154,81,15,120,143,762
445,Kemba Walker\walkeke02,PG,25,CHO,81,81,2885,568,1331,.427,182,490,.371,386,841,.459,.495,371,438,.847,56,301,357,421,126,39,171,111,1689
446,John Wall\walljo01,PG,25,WAS,77,77,2784,572,1349,.424,115,328,.351,457,1021,.448,.467,272,344,.791,42,337,379,789,145,59,318,159,1531
447,T.J. Warren\warretj01,SF,22,PHO,47,4,1070,221,441,.501,28,70,.400,193,371,.520,.533,45,64,.703,57,90,147,44,37,16,32,94,515
448,C.J. Watson\watsocj01,PG,31,ORL,33,2,656,47,137,.343,14,48,.292,33,89,.371,.394,34,39,.872,10,56,66,88,19,5,25,49,142
449,Briante Weber\weberbr01,PG,23,TOT,7,4,169,14,39,.359,0,5,.000,14,34,.412,.359,3,4,.750,8,17,25,21,9,3,9,12,31
449,Briante Weber\weberbr01,PG,23,MEM,6,4,166,13,38,.342,0,5,.000,13,33,.394,.342,3,4,.750,8,16,24,20,9,3,9,11,29
449,Briante Weber\weberbr01,PG,23,MIA,1,0,3,1,1,1.000,0,0,,1,1,1.000,1.000,0,0,,0,1,1,1,0,0,0,1,2
450,Sonny Weems\weemsso01,SG-SF,29,TOT,43,0,499,42,110,.382,15,41,.366,27,69,.391,.450,8,15,.533,7,46,53,49,10,1,41,47,107
450,Sonny Weems\weemsso01,SG,29,PHO,36,0,421,35,89,.393,13,32,.406,22,57,.386,.466,7,13,.538,6,35,41,47,10,1,37,40,90
450,Sonny Weems\weemsso01,SF,29,PHI,7,0,78,7,21,.333,2,9,.222,5,12,.417,.381,1,2,.500,1,11,12,2,0,0,4,7,17
451,David West\westda01,PF,35,SAS,78,19,1404,244,448,.545,3,7,.429,241,441,.546,.548,63,80,.788,72,237,309,143,44,55,68,142,554
452,Russell Westbrook\westbru01,PG,27,OKC,80,80,2750,656,1444,.454,101,341,.296,555,1103,.503,.489,465,573,.812,145,481,626,834,163,20,342,200,1878
453,Hassan Whiteside\whiteha01,C,26,MIA,73,43,2125,413,682,.606,0,0,,413,682,.606,.606,214,329,.650,238,627,865,30,44,269,137,201,1040
454,Shayne Whittington\whittsh01,PF,24,IND,7,0,41,5,11,.455,0,2,.000,5,9,.556,.455,1,2,.500,5,7,12,3,1,1,5,7,11
455,Andrew Wiggins\wiggian01,SF,20,MIN,81,81,2845,594,1294,.459,57,190,.300,537,1104,.486,.481,430,565,.761,105,186,291,164,78,46,182,165,1675
456,C.J. Wilcox\wilcocj01,SG,25,LAC,23,0,167,26,66,.394,9,23,.391,17,43,.395,.462,9,12,.750,1,11,12,10,10,2,2,15,70
457,Alan Williams\willial03,PF,23,PHO,10,0,68,10,24,.417,0,0,,10,24,.417,.417,9,14,.643,14,24,38,5,4,5,6,15,29
458,Deron Williams\willide01,PG,31,DAL,65,63,2106,321,775,.414,97,282,.344,224,493,.454,.477,179,206,.869,19,171,190,378,61,14,150,155,918
459,Derrick Williams\willide02,SF,24,NYK,80,9,1435,254,565,.450,44,150,.293,210,415,.506,.488,194,256,.758,47,249,296,75,29,9,61,69,746
460,Elliot Williams\williel01,PG,26,MEM,5,0,45,2,10,.200,1,4,.250,1,6,.167,.250,3,4,.750,1,3,4,4,0,0,1,2,8
461,Lou Williams\willilo02,SG,29,LAL,67,35,1907,283,693,.408,110,320,.344,173,373,.464,.488,352,424,.830,31,138,169,167,62,19,107,107,1028
462,Marvin Williams\willima02,PF,29,CHO,81,81,2338,338,747,.452,152,378,.402,186,369,.504,.554,120,144,.833,127,394,521,110,58,77,62,133,948
463,Mo Williams\willima01,PG,33,CLE,41,14,748,132,302,.437,36,102,.353,96,200,.480,.497,38,42,.905,6,66,72,98,14,5,57,60,338
464,Justise Winslow\winslju01,SF,19,MIA,78,8,2232,195,462,.422,32,116,.276,163,346,.471,.457,80,117,.684,81,322,403,117,68,26,95,184,502
465,Jeff Withey\witheje01,C,25,UTA,51,10,658,87,162,.537,0,2,.000,87,160,.544,.537,43,59,.729,56,117,173,20,21,53,28,75,217
466,Christian Wood\woodch01,PF,20,PHI,17,0,145,22,53,.415,4,11,.364,18,42,.429,.453,13,21,.619,13,25,38,3,5,7,2,11,61
467,Metta World Peace\artesro01,SF,36,LAL,35,5,590,55,177,.311,26,84,.310,29,93,.312,.384,40,57,.702,19,70,89,27,22,11,15,67,176
468,Brandan Wright\wrighbr03,PF,28,MEM,12,2,212,35,52,.673,0,0,,35,52,.673,.673,13,24,.542,14,29,43,6,5,15,10,21,83
469,Delon Wright\wrighde01,PG,23,TOR,27,1,229,36,80,.450,5,13,.385,31,67,.463,.481,26,35,.743,8,29,37,31,8,3,16,7,103
470,Tony Wroten\wroteto01,PG,22,PHI,8,3,144,22,65,.338,3,17,.176,19,48,.396,.362,20,37,.541,2,19,21,20,3,0,29,11,67
471,James Young\youngja01,SG,20,BOS,29,0,199,11,36,.306,6,26,.231,5,10,.500,.389,1,4,.250,4,22,26,9,6,1,5,17,29
472,Joe Young\youngjo01,PG,23,IND,41,0,384,62,169,.367,10,46,.217,52,123,.423,.396,20,25,.800,6,44,50,65,15,0,33,30,154
473,Nick Young\youngni01,SG,30,LAL,54,2,1033,126,372,.339,77,237,.325,49,135,.363,.442,63,76,.829,14,83,97,34,23,7,30,50,392
474,Thaddeus Young\youngth01,PF,27,BRK,73,73,2407,495,963,.514,7,30,.233,488,933,.523,.518,105,163,.644,176,484,660,135,112,37,136,182,1102
475,Cody Zeller\zelleco01,C,23,CHO,73,60,1774,231,437,.529,1,10,.100,230,427,.539,.530,175,232,.754,138,317,455,71,57,63,68,204,638
476,Tyler Zeller\zellety01,C,26,BOS,60,3,710,138,290,.476,0,0,,138,290,.476,.476,88,108,.815,62,116,178,29,10,22,46,97,364
