Rk,Player,Pos,Age,Tm,G,GS,MP,FG,FGA,FG%,3P,3PA,3P%,2P,2PA,2P%,eFG%,FT,FTA,FT%,ORB,DRB,TRB,AST,STL,BLK,TOV,PF,PTS
1,Alex Abrines\abrinal01,SG,23,OKC,68,6,1055,134,341,.393,94,247,.381,40,94,.426,.531,44,49,.898,18,68,86,40,37,8,33,114,406
2,Quincy Acy\acyqu01,PF,26,TOT,38,1,558,70,170,.412,37,90,.411,33,80,.413,.521,45,60,.750,20,95,115,18,14,15,21,67,222
2,Quincy Acy\acyqu01,PF,26,DAL,6,0,48,5,17,.294,1,7,.143,4,10,.400,.324,2,3,.667,2,6,8,0,0,0,2,9,13
2,Quincy Acy\acyqu01,PF,26,BRK,32,1,510,65,153,.425,36,83,.434,29,70,.414,.542,43,57,.754,18,89,107,18,14,15,19,58,209
3,Steven Adams\adamsst01,C,23,OKC,80,80,2389,374,655,.571,0,1,.000,374,654,.572,.571,157,257,.611,281,332,613,86,89,78,146,195,905
4,Arron Afflalo\afflaar01,SG,31,SAC,61,45,1580,185,420,.440,62,151,.411,123,269,.457,.514,83,93,.892,9,116,125,78,21,6,42,104,515
5,Alexis Ajinca\ajincal01,C,28,NOP,39,15,584,89,178,.500,0,4,.000,89,174,.511,.500,29,40,.725,46,131,177,12,20,22,31,77,207
6,Cole Aldrich\aldrico01,C,28,MIN,62,0,531,45,86,.523,0,0,,45,86,.523,.523,15,22,.682,51,107,158,25,25,23,17,85,105
7,LaMarcus Aldridge\aldrila01,PF,31,SAS,72,72,2335,500,1049,.477,23,56,.411,477,993,.480,.488,220,271,.812,172,351,523,139,46,88,98,158,1243
8,Lavoy Allen\allenla01,PF,27,IND,61,5,871,77,168,.458,0,1,.000,77,167,.461,.458,23,33,.697,105,114,219,57,18,24,29,78,177
9,Tony Allen\allento01,SG,35,MEM,71,66,1914,274,595,.461,15,54,.278,259,541,.479,.473,80,130,.615,166,225,391,98,115,29,100,178,643
10,Al-Farouq Aminu\aminual01,PF,26,POR,61,25,1773,183,466,.393,70,212,.330,113,254,.445,.468,96,136,.706,77,374,451,99,60,44,94,102,532
11,Chris Andersen\anderch01,C,38,CLE,12,0,114,9,22,.409,0,3,.000,9,19,.474,.409,10,14,.714,9,22,31,5,5,7,5,20,28
12,Alan Anderson\anderal01,SF,34,LAC,30,0,308,30,80,.375,14,44,.318,16,36,.444,.463,12,16,.750,3,21,24,11,3,0,7,35,86
13,Justin Anderson\anderju01,SF,23,TOT,75,10,1228,186,439,.424,58,194,.299,128,245,.522,.490,102,129,.791,69,176,245,66,41,23,66,109,532
13,Justin Anderson\anderju01,SF,23,DAL,51,2,710,111,277,.401,37,122,.303,74,155,.477,.468,70,88,.795,39,110,149,32,28,16,40,64,329
13,Justin Anderson\anderju01,SF,23,PHI,24,8,518,75,162,.463,21,72,.292,54,90,.600,.528,32,41,.780,30,66,96,34,13,7,26,45,203
14,Kyle Anderson\anderky01,SF,23,SAS,72,14,1020,93,209,.445,15,40,.375,78,169,.462,.481,45,57,.789,33,175,208,91,51,26,39,63,246
15,Ryan Anderson\anderry01,PF,28,HOU,72,72,2116,323,773,.418,204,506,.403,119,267,.446,.550,129,150,.860,112,218,330,68,31,14,55,142,979
16,Giannis Antetokounmpo\antetgi01,SF,22,MIL,80,80,2845,656,1259,.521,49,180,.272,607,1079,.563,.541,471,612,.770,142,558,700,434,131,151,234,246,1832
17,Carmelo Anthony\anthoca01,SF,32,NYK,74,74,2538,602,1389,.433,151,421,.359,451,968,.466,.488,304,365,.833,62,376,438,213,60,34,153,198,1659
18,Joel Anthony\anthojo01,C,34,SAS,19,0,122,10,16,.625,0,0,,10,16,.625,.625,5,8,.625,8,23,31,3,2,6,4,11,25
19,Trevor Ariza\arizatr01,SF,31,HOU,80,80,2773,326,798,.409,191,555,.344,135,243,.556,.528,93,126,.738,54,404,458,175,147,20,73,133,936
20,Darrell Arthur\arthuda01,PF,28,DEN,41,7,639,95,215,.442,53,117,.453,42,98,.429,.565,19,22,.864,25,87,112,42,19,21,36,76,262
21,Omer Asik\asikom01,C,30,NOP,31,19,482,31,65,.477,0,0,,31,65,.477,.477,23,39,.590,48,115,163,15,5,10,14,51,85
22,D.J. Augustin\augusdj01,PG,29,ORL,78,20,1538,195,517,.377,95,274,.347,100,243,.412,.469,131,161,.814,15,102,117,209,31,1,90,101,616
23,Luke Babbitt\babbilu01,SF,27,MIA,68,55,1065,113,281,.402,87,210,.414,26,71,.366,.557,11,15,.733,12,129,141,36,20,11,25,118,324
24,Ron Baker\bakerro01,SG,23,NYK,52,13,857,82,217,.378,23,86,.267,59,131,.450,.431,28,43,.651,12,86,98,107,34,8,56,74,215
25,Wade Baldwin\baldwwa01,PG,20,MEM,33,1,405,36,115,.313,3,22,.136,33,93,.355,.326,31,37,.838,11,35,46,61,18,7,39,40,106
26,Leandro Barbosa\barbole01,SG,34,PHO,67,0,963,172,392,.439,35,98,.357,137,294,.466,.483,40,45,.889,15,89,104,81,31,8,48,82,419
27,J.J. Barea\bareajo01,PG,32,DAL,35,6,771,142,343,.414,53,148,.358,89,195,.456,.491,44,51,.863,9,75,84,193,14,1,63,30,381
28,Harrison Barnes\barneha02,PF,24,DAL,79,79,2803,599,1280,.468,78,222,.351,521,1058,.492,.498,242,281,.861,93,301,394,116,65,15,102,128,1518
29,Matt Barnes\barnema02,SF,36,TOT,74,18,1777,185,473,.391,87,263,.331,98,210,.467,.483,70,89,.787,70,314,384,195,48,26,107,185,527
29,Matt Barnes\barnema02,SF,36,SAC,54,13,1367,147,383,.384,69,211,.327,78,172,.453,.474,50,66,.758,55,238,293,150,36,17,83,138,413
29,Matt Barnes\barnema02,SF,36,GSW,20,5,410,38,90,.422,18,52,.346,20,38,.526,.522,20,23,.870,15,76,91,45,12,9,24,47,114
30,Will Barton\bartowi01,SG,26,DEN,60,19,1705,295,666,.443,87,235,.370,208,431,.483,.508,143,190,.753,58,201,259,206,48,28,97,110,820
31,Brandon Bass\bassbr01,PF,31,LAC,52,0,577,107,186,.575,1,3,.333,106,183,.579,.578,77,88,.875,43,86,129,21,14,11,29,45,292
32,Nicolas Batum\batumni01,SG,28,CHO,77,77,2617,393,975,.403,135,405,.333,258,570,.453,.472,243,284,.856,46,435,481,456,86,29,194,109,1164
33,Jerryd Bayless\bayleje01,PG,28,PHI,3,1,71,11,32,.344,2,5,.400,9,27,.333,.375,9,10,.900,3,9,12,13,0,0,9,4,33
34,Aron Baynes\baynear01,C,30,DET,75,2,1163,143,279,.513,0,0,,143,279,.513,.513,79,94,.840,111,222,333,32,17,39,50,166,365
35,Kent Bazemore\bazemke01,SF,27,ATL,73,64,1963,295,721,.409,92,266,.346,203,455,.446,.473,119,168,.708,45,186,231,177,91,52,125,165,801
36,Bradley Beal\bealbr01,SG,23,WAS,77,77,2684,637,1322,.482,223,552,.404,414,770,.538,.566,282,342,.825,53,187,240,267,83,21,156,169,1779
37,Malik Beasley\beaslma01,SG,20,DEN,22,1,165,33,73,.452,9,28,.321,24,45,.533,.514,8,10,.800,5,12,17,11,7,0,8,10,83
38,Michael Beasley\beaslmi01,PF,28,MIL,56,6,935,216,406,.532,18,43,.419,198,363,.545,.554,78,105,.743,40,153,193,53,27,27,66,92,528
39,Marco Belinelli\belinma01,SG,30,CHO,74,0,1778,264,615,.429,102,283,.360,162,332,.488,.512,150,168,.893,14,164,178,147,44,9,70,90,780
40,DeAndre' Bembry\bembrde01,SF,22,ATL,38,1,371,47,98,.480,1,18,.056,46,80,.575,.485,6,16,.375,14,45,59,28,8,5,16,21,101
41,Dragan Bender\bendedr01,PF,19,PHO,43,0,574,57,161,.354,28,101,.277,29,60,.483,.441,4,11,.364,23,80,103,23,10,22,32,74,146
42,Anthony Bennett\bennean01,PF,23,BRK,23,1,264,38,92,.413,13,48,.271,25,44,.568,.484,26,36,.722,25,53,78,12,5,3,12,18,115
43,Ben Bentil\bentibe01,PF,21,DAL,3,0,10,0,3,.000,0,1,.000,0,2,.000,.000,0,0,,0,2,2,0,0,0,1,1,0
44,Davis Bertans\bertada01,PF,24,SAS,67,6,808,103,234,.440,69,173,.399,34,61,.557,.588,28,34,.824,22,76,98,46,20,28,32,75,303
45,Patrick Beverley\beverpa01,SG,28,HOU,67,67,2058,228,543,.420,110,288,.382,118,255,.463,.521,73,95,.768,95,298,393,281,99,25,100,222,639
46,Bismack Biyombo\biyombi01,C,24,ORL,81,27,1793,179,339,.528,0,0,,179,339,.528,.528,125,234,.534,157,410,567,74,25,91,95,202,483
47,Nemanja Bjelica\bjeline01,PF,28,MIN,65,1,1190,151,356,.424,56,177,.316,95,179,.531,.503,45,61,.738,57,187,244,79,40,20,59,154,403
48,Tarik Black\blackta01,C,25,LAL,67,16,1091,150,294,.510,1,2,.500,149,292,.510,.512,82,109,.752,144,199,343,39,29,44,58,173,383
49,Eric Bledsoe\bledser01,PG,27,PHO,66,66,2176,449,1034,.434,104,310,.335,345,724,.477,.485,388,458,.847,52,268,320,418,91,31,224,164,1390
50,Bojan Bogdanovic\bogdabo02,SF,27,TOT,81,54,2083,376,845,.445,144,392,.367,232,453,.512,.530,217,243,.893,37,240,277,111,34,7,131,146,1113
50,Bojan Bogdanovic\bogdabo02,SF,27,BRK,55,54,1482,269,611,.440,99,277,.357,170,334,.509,.521,146,167,.874,23,174,197,90,24,3,93,99,783
50,Bojan Bogdanovic\bogdabo02,SF,27,WAS,26,0,601,107,234,.457,45,115,.391,62,119,.521,.553,71,76,.934,14,66,80,21,10,4,38,47,330
51,Andrew Bogut\bogutan01,C,32,TOT,27,21,583,38,81,.469,0,1,.000,38,80,.475,.469,3,11,.273,56,162,218,49,13,25,43,86,79
51,Andrew Bogut\bogutan01,C,32,DAL,26,21,582,38,81,.469,0,1,.000,38,80,.475,.469,3,11,.273,56,162,218,49,13,25,43,84,79
51,Andrew Bogut\bogutan01,C,32,CLE,1,0,1,0,0,,0,0,,0,0,,,0,0,,0,0,0,0,0,0,0,2,0
52,Joel Bolomboy\bolomjo01,PF,23,UTA,12,0,53,9,16,.563,1,4,.250,8,12,.667,.594,3,6,.500,4,13,17,2,1,2,2,1,22
53,Devin Booker\bookede01,SG,20,PHO,78,78,2730,606,1431,.423,147,405,.363,459,1026,.447,.475,367,441,.832,46,203,249,268,72,21,241,242,1726
54,Trevor Booker\booketr01,PF,29,BRK,71,43,1754,305,591,.516,25,78,.321,280,513,.546,.537,74,110,.673,143,428,571,138,75,28,127,152,709
55,Avery Bradley\bradlav01,SG,26,BOS,55,55,1835,359,775,.463,108,277,.390,251,498,.504,.533,68,93,.731,65,269,334,122,68,11,88,141,894
56,Corey Brewer\breweco01,SF,30,TOT,82,11,1281,147,348,.422,27,118,.229,120,230,.522,.461,50,68,.735,32,134,166,97,61,20,55,133,371
56,Corey Brewer\breweco01,SF,30,HOU,58,8,923,94,227,.414,22,94,.234,72,133,.541,.463,32,44,.727,21,93,114,61,37,12,36,104,242
56,Corey Brewer\breweco01,SF,30,LAL,24,3,358,53,121,.438,5,24,.208,48,97,.495,.459,18,24,.750,11,41,52,36,24,8,19,29,129
57,Malcolm Brogdon\brogdma01,SG,24,MIL,75,28,1982,290,635,.457,78,193,.404,212,442,.480,.518,109,126,.865,47,166,213,317,84,12,113,140,767
58,Aaron Brooks\brookaa01,PG,32,IND,65,0,894,121,300,.403,48,128,.375,73,172,.424,.483,32,40,.800,18,51,69,125,25,9,66,93,322
59,Anthony Brown\brownan02,SF,24,TOT,11,0,159,18,50,.360,7,27,.259,11,23,.478,.430,0,0,,8,25,33,8,5,1,6,15,43
59,Anthony Brown\brownan02,SF,24,NOP,9,0,143,14,41,.341,6,24,.250,8,17,.471,.415,0,0,,6,20,26,6,5,1,5,13,34
59,Anthony Brown\brownan02,SF,24,ORL,2,0,16,4,9,.444,1,3,.333,3,6,.500,.500,0,0,,2,5,7,2,0,0,1,2,9
60,Bobby Brown\brownbo02,PG,32,HOU,25,0,123,23,60,.383,14,35,.400,9,25,.360,.500,2,2,1.000,0,6,6,14,1,0,5,5,62
61,Jaylen Brown\brownja02,SF,20,BOS,78,20,1341,192,423,.454,46,135,.341,146,288,.507,.508,85,124,.685,45,175,220,64,35,18,68,142,515
62,Nicolas Brussino\brussni01,SG,23,DAL,54,2,521,52,141,.369,29,95,.305,23,46,.500,.472,17,22,.773,26,69,95,47,17,8,26,43,150
63,Reggie Bullock\bullore01,SF,25,DET,31,5,467,54,128,.422,28,73,.384,26,55,.473,.531,5,7,.714,13,51,64,29,18,3,10,22,141
64,Trey Burke\burketr01,PG,24,WAS,57,0,703,116,255,.455,31,70,.443,85,185,.459,.516,22,29,.759,7,40,47,100,11,5,48,54,285
65,Alec Burks\burksal01,SG,25,UTA,42,0,653,99,248,.399,25,76,.329,74,172,.430,.450,60,78,.769,17,103,120,30,18,5,35,50,283
66,Jimmy Butler\butleji01,SF,27,CHI,76,75,2809,570,1252,.455,91,248,.367,479,1004,.477,.492,585,676,.865,129,341,470,417,143,32,159,112,1816
67,Bruno Caboclo\cabocbr01,SF,21,TOR,9,0,40,6,16,.375,2,6,.333,4,10,.400,.438,0,0,,5,5,10,4,2,1,2,4,14
68,Jose Calderon\caldejo01,PG,35,TOT,41,13,539,55,134,.410,20,64,.313,35,70,.500,.485,11,12,.917,15,59,74,88,11,1,41,36,141
68,Jose Calderon\caldejo01,PG,35,LAL,24,11,292,32,77,.416,12,34,.353,20,43,.465,.494,4,4,1.000,8,34,42,51,7,1,26,22,80
68,Jose Calderon\caldejo01,PG,35,ATL,17,2,247,23,57,.404,8,30,.267,15,27,.556,.474,7,8,.875,7,25,32,37,4,0,15,14,61
69,Kentavious Caldwell-Pope\caldwke01,SG,23,DET,76,75,2529,370,928,.399,153,437,.350,217,491,.442,.481,154,185,.832,55,193,248,193,89,12,86,118,1047
70,Isaiah Canaan\canaais01,SG,25,CHI,39,0,592,63,173,.364,25,94,.266,38,79,.481,.436,30,33,.909,6,44,50,37,22,1,21,35,181
71,Clint Capela\capelca01,C,22,HOU,65,59,1551,362,563,.643,0,0,,362,563,.643,.643,94,177,.531,178,348,526,63,34,79,87,179,818
72,DeMarre Carroll\carrode01,SF,30,TOR,72,72,1882,220,550,.400,109,320,.341,111,230,.483,.499,89,117,.761,63,212,275,74,81,27,54,143,638
73,Vince Carter\cartevi01,SF,40,MEM,73,15,1799,193,490,.394,112,296,.378,81,194,.418,.508,88,115,.765,36,191,227,133,60,36,50,163,586
74,Michael Carter-Williams\cartemi01,PG,25,CHI,45,19,846,112,306,.366,15,64,.234,97,242,.401,.391,58,77,.753,24,129,153,113,38,23,66,102,297
75,Omri Casspi\casspom01,PF,28,TOT,36,2,643,77,164,.470,15,43,.349,62,121,.512,.515,17,29,.586,27,85,112,37,23,3,29,50,186
75,Omri Casspi\casspom01,PF,28,SAC,22,2,397,53,117,.453,11,29,.379,42,88,.477,.500,12,21,.571,20,70,90,26,10,1,17,23,129
75,Omri Casspi\casspom01,PF,28,NOP,1,0,24,5,9,.556,2,4,.500,3,5,.600,.667,0,0,,1,1,2,0,0,0,2,3,12
75,Omri Casspi\casspom01,PF,28,MIN,13,0,222,19,38,.500,2,10,.200,17,28,.607,.526,5,8,.625,6,14,20,11,13,2,10,24,45
76,Willie Cauley-Stein\caulewi01,C,23,SAC,75,21,1421,255,481,.530,0,2,.000,255,479,.532,.530,101,151,.669,85,254,339,80,53,44,69,147,611
77,Tyson Chandler\chandty01,C,34,PHO,47,46,1298,153,228,.671,0,0,,153,228,.671,.671,91,124,.734,153,386,539,30,33,24,65,126,397
78,Wilson Chandler\chandwi01,SF,29,DEN,71,33,2197,433,939,.461,110,326,.337,323,613,.527,.520,141,194,.727,103,357,460,141,51,30,114,172,1117
79,Marquese Chriss\chrisma01,PF,19,PHO,82,75,1743,284,632,.449,72,224,.321,212,408,.520,.506,113,181,.624,96,252,348,60,67,70,108,263,753
80,Rakeem Christmas\chrisra01,PF,25,IND,29,0,219,19,43,.442,0,0,,19,43,.442,.442,21,29,.724,26,30,56,4,3,6,8,37,59
81,Semaj Christon\chrisse01,PG,24,OKC,64,1,973,77,223,.345,12,63,.190,65,160,.406,.372,17,31,.548,19,68,87,130,28,7,43,79,183
82,Ian Clark\clarkia01,SG,25,GSW,77,0,1137,211,433,.487,61,163,.374,150,270,.556,.558,44,58,.759,22,99,121,90,39,8,55,77,527
83,Jordan Clarkson\clarkjo01,SG,24,LAL,82,19,2397,477,1071,.445,117,356,.329,360,715,.503,.500,134,168,.798,49,197,246,213,88,8,164,150,1205
84,Norris Cole\coleno01,PG,28,OKC,13,0,125,16,52,.308,3,13,.231,13,39,.333,.337,8,10,.800,0,11,11,14,8,0,7,18,43
85,Darren Collison\collida01,PG,29,SAC,68,64,2063,340,714,.476,73,175,.417,267,539,.495,.527,147,171,.860,23,129,152,312,67,9,114,119,900
86,Nick Collison\collini01,PF,36,OKC,20,0,128,14,23,.609,0,1,.000,14,22,.636,.609,5,8,.625,9,22,31,12,2,2,4,17,33
87,Mike Conley\conlemi01,PG,29,MEM,69,68,2292,464,1009,.460,171,419,.408,293,590,.497,.545,316,368,.859,31,210,241,433,92,19,156,126,1415
88,Pat Connaughton\connapa01,SG,24,POR,39,1,316,37,72,.514,17,33,.515,20,39,.513,.632,7,9,.778,10,42,52,28,6,2,17,23,98
89,Quinn Cook\cookqu01,PG,23,TOT,14,0,188,33,66,.500,11,26,.423,22,40,.550,.583,2,5,.400,1,6,7,26,4,0,13,13,79
89,Quinn Cook\cookqu01,PG,23,DAL,5,0,77,11,25,.440,5,14,.357,6,11,.545,.540,0,2,.000,0,3,3,12,1,0,8,6,27
89,Quinn Cook\cookqu01,PG,23,NOP,9,0,111,22,41,.537,6,12,.500,16,29,.552,.610,2,3,.667,1,3,4,14,3,0,5,7,52
90,DeMarcus Cousins\couside01,C,26,TOT,72,72,2465,647,1432,.452,131,363,.361,516,1069,.483,.498,517,670,.772,152,642,794,332,100,93,269,278,1942
90,DeMarcus Cousins\couside01,C,26,SAC,55,55,1891,505,1118,.452,95,267,.356,410,851,.482,.494,423,549,.770,115,468,583,266,75,74,207,203,1528
90,DeMarcus Cousins\couside01,C,26,NOP,17,17,574,142,314,.452,36,96,.375,106,218,.486,.510,94,121,.777,37,174,211,66,25,19,62,75,414
91,Robert Covington\covinro01,SF,26,PHI,67,67,2119,292,732,.399,137,412,.333,155,320,.484,.492,143,174,.822,92,344,436,102,127,69,131,203,864
92,Allen Crabbe\crabbal01,SG,24,POR,79,7,2254,303,647,.468,134,302,.444,169,345,.490,.572,105,124,.847,19,207,226,94,54,20,62,171,845
93,Jamal Crawford\crawfja01,SG,36,LAC,82,1,2157,359,870,.413,116,322,.360,243,548,.443,.479,174,203,.857,17,112,129,214,61,14,134,115,1008
94,Jordan Crawford\crawfjo02,SG,28,NOP,19,0,442,105,218,.482,37,95,.389,68,123,.553,.567,20,26,.769,4,30,34,57,11,2,25,30,267
95,Jae Crowder\crowdja01,SF,26,BOS,72,72,2335,333,720,.463,157,394,.398,176,326,.540,.572,176,217,.811,48,367,415,155,73,23,80,161,999
96,Dante Cunningham\cunnida01,PF,29,NOP,66,35,1649,174,359,.485,71,181,.392,103,178,.579,.584,16,27,.593,56,221,277,37,39,28,28,100,435
97,Seth Curry\curryse01,PG,26,DAL,70,42,2029,338,703,.481,137,322,.425,201,381,.528,.578,85,100,.850,25,154,179,189,79,7,92,126,898
98,Stephen Curry\curryst01,PG,28,GSW,79,79,2638,675,1443,.468,324,789,.411,351,654,.537,.580,325,362,.898,61,292,353,524,142,17,239,183,1999
99,Troy Daniels\danietr01,SG,25,MEM,67,3,1183,185,495,.374,138,355,.389,47,140,.336,.513,43,54,.796,22,78,100,46,20,4,45,90,551
100,Anthony Davis\davisan02,C,23,NOP,75,75,2708,770,1526,.505,40,134,.299,730,1392,.524,.518,519,647,.802,172,712,884,157,94,167,181,168,2099
101,Deyonta Davis\davisde01,C,20,MEM,36,0,238,24,47,.511,0,0,,24,47,.511,.511,10,18,.556,20,40,60,2,3,17,8,40,58
102,Ed Davis\davised01,PF,27,POR,46,12,789,75,142,.528,0,0,,75,142,.528,.528,50,81,.617,96,148,244,26,15,22,37,137,200
103,Dewayne Dedmon\dedmode01,C,27,SAS,76,37,1330,161,259,.622,0,0,,161,259,.622,.622,65,93,.699,129,367,496,44,37,61,61,180,387
104,Sam Dekker\dekkesa01,PF,22,HOU,77,2,1419,203,429,.473,60,187,.321,143,242,.591,.543,38,68,.559,94,190,284,76,38,21,41,83,504
105,Malcolm Delaney\delanma01,PG,27,ATL,73,2,1248,145,388,.374,26,110,.236,119,278,.428,.407,75,93,.806,10,113,123,193,39,1,95,112,391
106,Matthew Dellavedova\dellama01,PG,26,MIL,76,54,1986,208,534,.390,79,215,.367,129,319,.404,.463,82,96,.854,24,123,147,357,53,0,133,153,577
107,Luol Deng\denglu01,SF,31,LAL,56,49,1486,164,424,.387,51,165,.309,113,259,.436,.447,46,63,.730,63,232,295,74,48,20,43,61,425
108,DeMar DeRozan\derozde01,SG,27,TOR,74,74,2620,721,1545,.467,33,124,.266,688,1421,.484,.477,545,647,.842,70,316,386,290,78,13,180,134,2020
109,Cheick Diallo\diallch01,PF,20,NOP,17,0,199,36,76,.474,0,0,,36,76,.474,.474,15,21,.714,23,50,73,4,4,7,7,17,87
110,Boris Diaw\diawbo01,PF,34,UTA,73,33,1283,146,327,.446,20,81,.247,126,246,.512,.477,26,35,.743,46,112,158,170,18,9,87,83,338
111,Gorgui Dieng\dienggo01,PF,27,MIN,82,82,2653,332,661,.502,16,43,.372,316,618,.511,.514,136,167,.814,188,459,647,158,88,95,107,254,816
112,Spencer Dinwiddie\dinwisp01,PG,23,BRK,59,18,1334,134,302,.444,38,101,.376,96,201,.478,.507,126,159,.792,27,137,164,185,44,23,66,119,432
113,Toney Douglas\douglto01,PG,30,MEM,24,0,394,43,117,.368,7,42,.167,36,75,.480,.397,24,29,.828,13,48,61,56,18,5,21,50,117
114,Goran Dragic\dragigo01,PG,30,MIA,73,73,2459,534,1124,.475,117,289,.405,417,835,.499,.527,298,377,.790,62,217,279,423,89,13,212,199,1483
115,Andre Drummond\drumman01,C,23,DET,81,81,2409,483,911,.530,2,7,.286,481,904,.532,.531,137,355,.386,345,770,1115,90,124,89,152,237,1105
116,Jared Dudley\dudleja01,PF,31,PHO,64,7,1362,157,346,.454,77,203,.379,80,143,.559,.565,43,65,.662,31,194,225,121,42,16,73,154,434
117,Mike Dunleavy\dunlemi02,SF,36,TOT,53,2,841,93,220,.423,53,134,.396,40,86,.465,.543,36,45,.800,18,97,115,50,15,7,28,67,275
117,Mike Dunleavy\dunlemi02,SF,36,CLE,23,2,366,36,90,.400,20,57,.351,16,33,.485,.511,14,19,.737,5,42,47,20,6,2,14,32,106
117,Mike Dunleavy\dunlemi02,SF,36,ATL,30,0,475,57,130,.438,33,77,.429,24,53,.453,.565,22,26,.846,13,55,68,30,9,5,14,35,169
118,Kris Dunn\dunnkr01,PG,22,MIN,78,7,1333,118,313,.377,21,73,.288,97,240,.404,.411,36,59,.610,24,142,166,188,78,36,89,178,293
119,Kevin Durant\duranke01,PF,28,GSW,62,62,2070,551,1026,.537,117,312,.375,434,714,.608,.594,336,384,.875,39,474,513,300,66,99,138,117,1555
120,Jarell Eddie\eddieja01,SF,25,PHO,5,0,62,6,19,.316,4,16,.250,2,3,.667,.421,8,9,.889,1,6,7,0,1,0,1,1,24
121,Henry Ellenson\ellenhe01,PF,20,DET,19,2,146,23,64,.359,10,35,.286,13,29,.448,.438,4,8,.500,8,33,41,7,1,1,14,6,60
122,Wayne Ellington\ellinwa01,SG,29,MIA,62,13,1500,231,555,.416,149,394,.378,82,161,.509,.550,37,43,.860,18,114,132,70,35,4,30,70,648
123,Monta Ellis\ellismo01,SG,31,IND,74,33,1998,247,557,.443,43,135,.319,204,422,.483,.482,93,128,.727,19,185,204,236,78,27,135,149,630
124,Joel Embiid\embiijo01,C,22,PHI,31,31,786,200,429,.466,36,98,.367,164,331,.495,.508,191,244,.783,61,182,243,66,27,76,117,112,627
125,James Ennis\ennisja01,SF,26,MEM,64,28,1501,146,321,.455,51,137,.372,95,184,.516,.534,86,110,.782,69,190,259,64,46,19,59,165,429
126,Tyler Ennis\ennisty01,PG,22,TOT,53,2,588,90,208,.433,27,70,.386,63,138,.457,.498,21,25,.840,9,36,45,86,25,2,45,58,228
126,Tyler Ennis\ennisty01,PG,22,HOU,31,0,196,25,64,.391,6,16,.375,19,48,.396,.438,2,3,.667,4,15,19,34,6,0,24,29,58
126,Tyler Ennis\ennisty01,PG,22,LAL,22,2,392,65,144,.451,21,54,.389,44,90,.489,.524,19,22,.864,5,21,26,52,19,2,21,29,170
127,Tyreke Evans\evansty01,SF,27,TOT,40,6,788,150,370,.405,42,118,.356,108,252,.429,.462,69,92,.750,13,124,137,124,35,9,61,60,411
127,Tyreke Evans\evansty01,SF,27,NOP,26,0,474,91,227,.401,21,70,.300,70,157,.446,.447,45,58,.776,6,80,86,91,23,4,39,41,248
127,Tyreke Evans\evansty01,SF,27,SAC,14,6,314,59,143,.413,21,48,.438,38,95,.400,.486,24,34,.706,7,44,51,33,12,5,22,19,163
128,Dante Exum\exumda01,PG,21,UTA,66,26,1228,155,363,.427,44,149,.295,111,214,.519,.488,58,73,.795,30,102,132,111,21,12,80,146,412
129,Kenneth Faried\farieke01,PF,27,DEN,61,34,1296,228,416,.548,0,6,.000,228,410,.556,.548,131,189,.693,183,279,462,55,43,40,59,124,587
130,Jordan Farmar\farmajo01,PG,30,SAC,2,0,35,4,12,.333,4,9,.444,0,3,.000,.500,0,0,,1,2,3,9,2,0,3,1,12
131,Derrick Favors\favorde01,PF,25,UTA,50,39,1186,203,417,.487,3,10,.300,200,407,.491,.490,67,109,.615,92,213,305,56,45,40,60,103,476
132,Kay Felder\feldeka01,PG,21,CLE,42,0,386,62,158,.392,7,22,.318,55,136,.404,.415,35,49,.714,3,38,41,58,18,7,30,38,166
133,Cristiano Felicio\feliccr01,C,24,CHI,66,0,1040,128,221,.579,0,0,,128,221,.579,.579,60,93,.645,124,187,311,40,25,17,33,110,316
134,Raymond Felton\feltora01,PG,32,LAC,80,11,1700,221,514,.430,46,144,.319,175,370,.473,.475,50,64,.781,33,185,218,191,66,22,83,125,538
135,Yogi Ferrell\ferreyo01,PG,23,TOT,46,29,1197,160,394,.406,68,176,.386,92,218,.422,.492,74,89,.831,20,91,111,172,42,9,70,90,462
135,Yogi Ferrell\ferreyo01,PG,23,BRK,10,0,151,18,49,.367,8,27,.296,10,22,.455,.449,10,16,.625,4,8,12,17,2,2,14,11,54
135,Yogi Ferrell\ferreyo01,PG,23,DAL,36,29,1046,142,345,.412,60,149,.403,82,196,.418,.499,64,73,.877,16,83,99,155,40,7,56,79,408
136,Dorian Finney-Smith\finnedo01,PF,23,DAL,81,35,1642,124,333,.372,56,191,.293,68,142,.479,.456,46,61,.754,55,167,222,67,52,25,45,125,350
137,Bryn Forbes\forbebr01,SG,23,SAS,36,0,285,36,99,.364,17,53,.321,19,46,.413,.449,5,6,.833,2,21,23,23,1,0,11,20,94
138,Evan Fournier\fournev01,SG,24,ORL,68,66,2234,408,930,.439,128,360,.356,280,570,.491,.508,223,277,.805,44,165,209,202,66,4,141,180,1167
139,Randy Foye\foyera01,SG,33,BRK,69,40,1284,118,325,.363,67,203,.330,51,122,.418,.466,54,63,.857,9,146,155,135,35,9,80,99,357
140,Tim Frazier\fraziti01,PG,26,NOP,65,35,1525,163,404,.403,40,128,.313,123,276,.446,.453,98,129,.760,34,139,173,335,56,6,101,133,464
141,Channing Frye\fryech01,C,33,CLE,74,15,1398,238,520,.458,137,335,.409,101,185,.546,.589,63,74,.851,37,253,290,45,33,37,53,138,676
142,Danilo Gallinari\gallida01,SF,28,DEN,63,63,2134,335,750,.447,126,324,.389,209,426,.491,.531,349,387,.902,39,286,325,135,40,15,82,93,1145
143,Langston Galloway\gallola01,PG,25,TOT,74,2,1495,207,545,.380,120,308,.390,87,237,.367,.490,51,64,.797,27,129,156,93,46,6,46,96,585
143,Langston Galloway\gallola01,PG,25,NOP,55,0,1120,165,441,.374,101,268,.377,64,173,.370,.489,40,52,.769,20,101,121,65,40,5,28,76,471
143,Langston Galloway\gallola01,PG,25,SAC,19,2,375,42,104,.404,19,40,.475,23,64,.359,.495,11,12,.917,7,28,35,28,6,1,18,20,114
144,Patricio Garino\garinpa01,SG,23,ORL,5,0,43,0,7,.000,0,5,.000,0,2,.000,.000,0,0,,1,6,7,0,0,0,3,4,0
145,Marc Gasol\gasolma01,C,32,MEM,74,74,2531,532,1160,.459,104,268,.388,428,892,.480,.503,278,332,.837,60,404,464,338,67,99,166,171,1446
146,Pau Gasol\gasolpa01,C,36,SAS,64,39,1627,303,604,.502,56,104,.538,247,500,.494,.548,130,184,.707,107,394,501,150,24,70,81,110,792
147,Rudy Gay\gayru01,SF,30,SAC,30,30,1013,201,442,.455,42,113,.372,159,329,.483,.502,118,138,.855,35,155,190,83,44,26,74,79,562
148,Michael Gbinije\gbinimi01,SG,24,DET,9,0,32,1,10,.100,0,4,.000,1,6,.167,.100,2,2,1.000,2,1,3,2,0,0,0,2,4
149,Alonzo Gee\geeal01,SF,29,DEN,13,0,89,3,14,.214,0,3,.000,3,11,.273,.214,5,9,.556,4,11,15,6,5,1,4,14,11
150,Paul George\georgpa01,SF,26,IND,75,75,2689,622,1348,.461,195,496,.393,427,852,.501,.534,336,374,.898,58,434,492,251,119,27,220,206,1775
151,Marcus Georges-Hunt\georgma01,SG,22,ORL,5,0,48,2,7,.286,1,2,.500,1,5,.200,.357,9,10,.900,1,8,9,3,1,0,2,5,14
152,Jonathan Gibson\gibsojo01,PG,29,DAL,17,0,231,35,95,.368,15,45,.333,20,50,.400,.447,21,29,.724,1,21,22,26,8,0,21,21,106
153,Taj Gibson\gibsota01,PF,31,TOT,78,71,1989,365,709,.515,3,13,.231,362,696,.520,.517,113,158,.715,158,327,485,73,41,65,105,163,846
153,Taj Gibson\gibsota01,PF,31,CHI,55,55,1502,276,530,.521,2,12,.167,274,518,.529,.523,85,119,.714,120,262,382,60,27,50,77,123,639
153,Taj Gibson\gibsota01,PF,31,OKC,23,16,487,89,179,.497,1,1,1.000,88,178,.494,.500,28,39,.718,38,65,103,13,14,15,28,40,207
154,Manu Ginobili\ginobma01,SG,39,SAS,69,0,1291,171,439,.390,89,227,.392,82,212,.387,.491,86,107,.804,28,129,157,183,82,16,96,119,517
155,Rudy Gobert\goberru01,C,24,UTA,81,81,2744,413,625,.661,0,1,.000,413,624,.662,.661,311,476,.653,314,721,1035,97,49,214,147,246,1137
156,Archie Goodwin\goodwar01,SG,22,TOT,15,0,214,36,66,.545,5,15,.333,31,51,.608,.583,33,42,.786,7,21,28,24,4,5,14,8,110
156,Archie Goodwin\goodwar01,SG,22,NOP,3,0,30,2,5,.400,1,2,.500,1,3,.333,.500,10,10,1.000,0,0,0,1,0,1,0,1,15
156,Archie Goodwin\goodwar01,SG,22,BRK,12,0,184,34,61,.557,4,13,.308,30,48,.625,.590,23,32,.719,7,21,28,23,4,4,14,7,95
157,Aaron Gordon\gordoaa01,SF,21,ORL,80,72,2298,393,865,.454,77,267,.288,316,598,.528,.499,156,217,.719,116,289,405,150,65,40,89,172,1019
158,Eric Gordon\gordoer01,SG,28,HOU,75,15,2323,412,1016,.406,246,661,.372,166,355,.468,.527,147,175,.840,29,172,201,188,48,41,121,150,1217
159,Marcin Gortat\gortama01,C,32,WAS,82,82,2556,390,674,.579,0,2,.000,390,672,.580,.579,103,159,.648,238,611,849,121,40,61,119,213,883
160,Treveon Graham\grahatr01,SG,23,CHO,27,1,189,19,40,.475,9,15,.600,10,25,.400,.588,10,15,.667,5,17,22,6,6,1,3,18,57
161,Jerami Grant\grantje01,PF,22,TOT,80,4,1531,152,328,.463,43,116,.371,109,212,.514,.529,90,147,.612,38,167,205,46,33,79,44,149,437
161,Jerami Grant\grantje01,PF,22,PHI,2,0,41,6,17,.353,0,2,.000,6,15,.400,.353,4,8,.500,0,6,6,0,0,4,3,5,16
161,Jerami Grant\grantje01,PF,22,OKC,78,4,1490,146,311,.469,43,114,.377,103,197,.523,.539,86,139,.619,38,161,199,46,33,75,41,144,421
162,Jerian Grant\grantje02,PG,24,CHI,63,28,1028,128,301,.425,49,134,.366,79,167,.473,.507,65,73,.890,17,94,111,121,47,8,44,93,370
163,Danny Green\greenda02,SG,29,SAS,68,68,1807,176,449,.392,118,311,.379,58,138,.420,.523,27,32,.844,31,193,224,124,70,57,76,120,497
164,Draymond Green\greendr01,PF,26,GSW,76,76,2471,272,650,.418,81,263,.308,191,387,.494,.481,151,213,.709,98,501,599,533,154,106,184,217,776
165,Gerald Green\greenge01,SF,31,BOS,47,0,538,95,232,.409,39,111,.351,56,121,.463,.494,33,41,.805,16,68,84,33,9,7,25,48,262
166,JaMychal Green\greenja01,PF,26,MEM,77,75,2101,250,500,.500,55,145,.379,195,355,.549,.555,134,167,.802,167,377,544,84,47,34,94,248,689
167,Jeff Green\greenje02,PF,30,ORL,69,11,1534,220,558,.394,53,193,.275,167,365,.458,.442,145,168,.863,39,175,214,81,37,13,75,103,638
168,Blake Griffin\griffbl01,PF,27,LAC,61,61,2076,479,971,.493,38,113,.336,441,858,.514,.513,320,421,.760,112,385,497,300,57,22,142,157,1316
169,Justin Hamilton\hamilju01,C,26,BRK,64,7,1177,174,379,.459,55,180,.306,119,199,.598,.532,39,52,.750,71,191,262,55,29,43,43,91,442
170,A.J. Hammons\hammoaj01,C,24,DAL,22,0,163,17,42,.405,5,10,.500,12,32,.375,.464,9,20,.450,8,28,36,4,1,13,10,21,48
171,Tim Hardaway\hardati02,SG,24,ATL,79,30,2154,415,912,.455,149,417,.357,266,495,.537,.537,164,214,.766,35,189,224,182,55,15,106,103,1143
172,James Harden\hardeja01,PG,27,HOU,81,81,2947,674,1533,.440,262,756,.347,412,777,.530,.525,746,881,.847,95,564,659,907,121,38,464,215,2356
173,Maurice Harkless\harklma01,SF,23,POR,77,69,2223,314,624,.503,68,194,.351,246,430,.572,.558,77,124,.621,125,216,341,88,85,70,86,214,773
174,Justin Harper\harpeju01,PF,27,PHI,3,0,31,5,12,.417,2,7,.286,3,5,.600,.500,0,0,,2,3,5,2,0,0,4,2,12
175,Montrezl Harrell\harremo01,C,23,HOU,58,14,1064,225,345,.652,1,7,.143,224,338,.663,.654,76,121,.628,81,138,219,64,20,42,44,126,527
176,Devin Harris\harride01,PG,33,DAL,65,0,1087,136,341,.399,58,177,.328,78,164,.476,.484,107,129,.829,11,116,127,136,43,7,57,101,437
177,Gary Harris\harriga01,SG,22,DEN,57,56,1782,320,637,.502,107,255,.420,213,382,.558,.586,104,134,.776,48,130,178,164,71,8,76,92,851
178,Joe Harris\harrijo01,SG,25,BRK,52,11,1138,154,362,.425,85,221,.385,69,141,.489,.543,35,49,.714,16,131,147,54,30,8,55,121,428
179,Manny Harris\harrima01,SG,27,DAL,4,0,25,3,15,.200,0,2,.000,3,13,.231,.200,2,4,.500,3,6,9,2,0,0,2,1,8
180,Tobias Harris\harrito02,PF,24,DET,82,48,2567,511,1063,.481,109,314,.347,402,749,.537,.532,190,226,.841,63,353,416,142,60,39,96,133,1321
181,Aaron Harrison\harriaa01,SG,22,CHO,5,0,17,0,4,.000,0,2,.000,0,2,.000,.000,1,2,.500,0,3,3,3,0,0,0,2,1
182,Andrew Harrison\harrian01,PG,22,MEM,72,18,1474,117,360,.325,43,156,.276,74,204,.363,.385,148,194,.763,23,113,136,198,53,21,85,194,425
183,Udonis Haslem\hasleud01,C,36,MIA,16,0,130,11,23,.478,0,3,.000,11,20,.550,.478,9,15,.600,8,28,36,6,6,1,8,22,31
184,Spencer Hawes\hawessp01,PF,28,TOT,54,1,797,134,277,.484,25,81,.309,109,196,.556,.529,44,52,.846,38,153,191,81,15,30,49,77,337
184,Spencer Hawes\hawessp01,PF,28,CHO,35,1,626,104,218,.477,16,55,.291,88,163,.540,.514,30,34,.882,32,114,146,62,13,26,40,61,254
184,Spencer Hawes\hawessp01,PF,28,MIL,19,0,171,30,59,.508,9,26,.346,21,33,.636,.585,14,18,.778,6,39,45,19,2,4,9,16,83
185,Gordon Hayward\haywago01,SF,26,UTA,73,73,2516,545,1156,.471,149,374,.398,396,782,.506,.536,362,429,.844,49,345,394,252,73,20,140,117,1601
186,Gerald Henderson\hendege02,SG,29,PHI,72,41,1667,234,553,.423,61,173,.353,173,380,.455,.478,133,165,.806,34,151,185,112,40,15,62,129,662
187,John Henson\hensojo01,C,26,MIL,58,39,1123,159,309,.515,0,1,.000,159,308,.516,.515,74,107,.692,92,203,295,57,29,78,52,151,392
188,Juan Hernangomez\hernaju01,PF,21,DEN,62,9,842,101,224,.451,46,113,.407,55,111,.495,.554,57,76,.750,43,144,187,29,30,12,31,62,305
189,Willy Hernangomez\hernawi01,C,22,NYK,72,22,1324,246,465,.529,4,15,.267,242,450,.538,.533,91,125,.728,170,332,502,96,41,36,100,150,587
190,Mario Hezonja\hezonma01,SF,21,ORL,65,2,960,117,330,.355,43,144,.299,74,186,.398,.420,40,50,.800,20,126,146,62,30,15,58,74,317
191,Roy Hibbert\hibbero01,C,30,TOT,48,13,682,80,147,.544,0,0,,80,147,.544,.544,61,75,.813,54,98,152,21,8,46,32,100,221
191,Roy Hibbert\hibbero01,C,30,CHO,42,13,671,78,144,.542,0,0,,78,144,.542,.542,61,75,.813,53,97,150,20,8,44,31,97,217
191,Roy Hibbert\hibbero01,C,30,DEN,6,0,11,2,3,.667,0,0,,2,3,.667,.667,0,0,,1,1,2,1,0,2,1,3,4
192,Buddy Hield\hieldbu01,SG,24,TOT,82,55,1888,327,767,.426,148,379,.391,179,388,.461,.523,64,76,.842,35,234,269,121,38,9,101,115,866
192,Buddy Hield\hieldbu01,SG,24,NOP,57,37,1161,185,471,.393,89,241,.369,96,230,.417,.487,29,33,.879,19,147,166,77,18,7,48,81,488
192,Buddy Hield\hieldbu01,SG,24,SAC,25,18,727,142,296,.480,59,138,.428,83,158,.525,.579,35,43,.814,16,87,103,44,20,2,53,34,378
193,Nene Hilario\hilarne01,C,34,HOU,67,8,1198,245,397,.617,3,9,.333,242,388,.624,.621,116,197,.589,95,187,282,65,56,39,73,163,609
194,George Hill\hillge01,PG,30,UTA,49,49,1544,289,606,.477,94,233,.403,195,373,.523,.554,157,196,.801,23,144,167,204,50,11,85,114,829
195,Jordan Hill\hilljo01,C,29,MIN,7,0,47,5,13,.385,0,0,,5,13,.385,.385,2,2,1.000,8,6,14,0,1,0,4,9,12
196,Solomon Hill\hillso01,SF,25,NOP,80,71,2374,183,478,.383,94,270,.348,89,208,.428,.481,103,128,.805,51,256,307,141,72,32,82,182,563
197,Darrun Hilliard\hillida01,SG,23,DET,39,1,381,47,126,.373,12,46,.261,35,80,.438,.421,21,28,.750,2,31,33,33,11,2,28,39,127
198,Jrue Holiday\holidjr01,PG,26,NOP,67,61,2190,405,893,.454,100,281,.356,305,612,.498,.510,119,168,.708,46,218,264,488,100,44,194,133,1029
199,Justin Holiday\holidju01,SG,27,NYK,82,4,1639,233,538,.433,97,273,.355,136,265,.513,.523,66,80,.825,27,198,225,102,65,31,66,109,629
200,Rondae Hollis-Jefferson\holliro01,SF,22,BRK,78,50,1761,235,542,.434,15,67,.224,220,475,.463,.447,190,253,.751,96,356,452,154,82,44,116,177,675
201,Richaun Holmes\holmeri01,C,23,PHI,57,17,1193,230,412,.558,27,77,.351,203,335,.606,.591,72,103,.699,94,217,311,58,42,55,55,136,559
202,Rodney Hood\hoodro01,SG,24,UTA,59,55,1593,272,666,.408,114,307,.371,158,359,.440,.494,90,115,.783,16,186,202,96,38,11,65,132,748
203,Al Horford\horfoal01,C,30,BOS,68,68,2193,379,801,.473,86,242,.355,293,559,.524,.527,108,135,.800,95,370,465,337,52,86,115,138,952
204,Danuel House\houseda01,SG,23,WAS,1,0,1,0,0,,0,0,,0,0,,,0,0,,0,1,1,0,0,0,0,0,0
205,Dwight Howard\howardw01,C,31,ATL,74,74,2199,388,613,.633,0,2,.000,388,611,.635,.633,226,424,.533,296,644,940,104,64,92,170,203,1002
206,Marcelo Huertas\huertma01,PG,33,LAL,23,1,237,25,68,.368,4,19,.211,21,49,.429,.397,9,17,.529,2,22,24,52,10,2,19,16,63
207,Josh Huestis\huestjo01,PF,25,OKC,2,0,31,6,11,.545,2,4,.500,4,7,.571,.636,0,1,.000,4,5,9,3,0,3,0,0,14
208,Kris Humphries\humphkr01,PF,31,ATL,56,4,689,87,214,.407,19,54,.352,68,160,.425,.451,64,82,.780,60,146,206,29,15,21,28,69,257
209,R.J. Hunter\hunterj01,SG,23,CHI,3,0,9,0,1,.000,0,1,.000,0,0,,.000,0,0,,0,1,1,0,0,0,0,0,0
210,Serge Ibaka\ibakase01,PF,27,TOT,79,79,2422,471,982,.480,124,317,.391,347,665,.522,.543,107,125,.856,129,409,538,75,41,124,105,215,1173
210,Serge Ibaka\ibakase01,PF,27,ORL,56,56,1710,343,703,.488,83,214,.388,260,489,.532,.547,77,91,.846,100,282,382,60,34,91,66,139,846
210,Serge Ibaka\ibakase01,PF,27,TOR,23,23,712,128,279,.459,41,103,.398,87,176,.494,.532,30,34,.882,29,127,156,15,7,33,39,76,327
211,Andre Iguodala\iguodan01,SF,33,GSW,76,0,1998,219,415,.528,64,177,.362,155,238,.651,.605,72,102,.706,51,253,304,261,76,39,58,97,574
212,Ersan Ilyasova\ilyaser01,PF,29,TOT,82,52,2142,384,890,.431,142,402,.353,242,488,.496,.511,161,207,.778,115,366,481,141,58,23,116,211,1071
212,Ersan Ilyasova\ilyaser01,PF,29,OKC,3,0,62,6,16,.375,3,12,.250,3,4,.750,.469,0,0,,2,14,16,1,3,1,4,5,15
212,Ersan Ilyasova\ilyaser01,PF,29,PHI,53,40,1447,285,648,.440,107,298,.359,178,350,.509,.522,109,142,.768,71,243,314,97,33,14,78,133,786
212,Ersan Ilyasova\ilyaser01,PF,29,ATL,26,12,633,93,226,.412,32,92,.348,61,134,.455,.482,52,65,.800,42,109,151,43,22,8,34,73,270
213,Joe Ingles\inglejo01,SF,29,UTA,82,26,1972,204,451,.452,123,279,.441,81,172,.471,.589,50,68,.735,23,238,261,225,96,8,107,163,581
214,Brandon Ingram\ingrabr01,SF,19,LAL,79,40,2279,276,686,.402,55,187,.294,221,499,.443,.442,133,214,.621,60,256,316,166,50,36,116,158,740
215,Kyrie Irving\irvinky01,PG,24,CLE,72,72,2525,671,1420,.473,177,441,.401,494,979,.505,.535,297,328,.905,52,178,230,418,83,24,180,157,1816
216,Jarrett Jack\jackja01,PG,33,NOP,2,0,33,2,3,.667,0,1,.000,2,2,1.000,.667,2,2,1.000,0,0,0,5,2,0,3,4,6
217,Demetrius Jackson\jacksde01,PG,22,BOS,5,0,17,3,4,.750,1,1,1.000,2,3,.667,.875,3,6,.500,2,2,4,3,0,0,0,0,10
218,Pierre Jackson\jackspi01,PG,25,DAL,8,1,84,13,39,.333,3,11,.273,10,28,.357,.372,6,7,.857,1,8,9,19,2,0,3,5,35
219,Reggie Jackson\jacksre01,PG,26,DET,52,50,1424,284,677,.419,66,184,.359,218,493,.442,.468,118,136,.868,21,93,114,270,35,5,114,129,752
220,LeBron James\jamesle01,SF,32,CLE,74,74,2794,736,1344,.548,124,342,.363,612,1002,.611,.594,358,531,.674,97,542,639,646,92,44,303,134,1954
221,Al Jefferson\jeffeal01,C,32,IND,66,1,931,235,471,.499,0,1,.000,235,470,.500,.499,65,85,.765,75,203,278,57,19,16,33,125,535
222,Richard Jefferson\jefferi01,SF,36,CLE,79,13,1614,153,343,.446,62,186,.333,91,157,.580,.536,80,108,.741,28,175,203,78,26,10,52,153,448
223,John Jenkins\jenkijo01,SG,25,PHO,4,0,13,2,5,.400,1,2,.500,1,3,.333,.500,2,2,1.000,0,1,1,1,0,0,0,0,7
224,Brandon Jennings\jennibr01,PG,27,TOT,81,13,1802,192,535,.359,79,252,.313,113,283,.399,.433,114,152,.750,29,167,196,395,70,4,128,116,577
224,Brandon Jennings\jennibr01,PG,27,NYK,58,11,1428,163,429,.380,68,200,.340,95,229,.415,.459,102,135,.756,21,131,152,287,55,4,106,84,496
224,Brandon Jennings\jennibr01,PG,27,WAS,23,2,374,29,106,.274,11,52,.212,18,54,.333,.325,12,17,.706,8,36,44,108,15,0,22,32,81
225,Jonas Jerebko\jerebjo01,PF,29,BOS,78,6,1232,114,262,.435,45,130,.346,69,132,.523,.521,26,37,.703,59,213,272,71,25,17,39,122,299
226,Amir Johnson\johnsam01,PF,29,BOS,80,77,1608,213,370,.576,27,66,.409,186,304,.612,.612,67,100,.670,118,248,366,140,51,62,77,211,520
227,Brice Johnson\johnsbr02,PF,22,LAC,3,0,9,2,7,.286,0,0,,2,7,.286,.286,0,0,,1,2,3,1,2,1,1,0,4
228,James Johnson\johnsja01,PF,29,MIA,76,5,2085,368,769,.479,87,256,.340,281,513,.548,.535,152,215,.707,66,310,376,276,76,86,171,197,975
229,Joe Johnson\johnsjo02,SF,35,UTA,78,14,1843,273,626,.436,106,258,.411,167,368,.454,.521,63,77,.818,33,210,243,144,36,18,69,93,715
230,Stanley Johnson\johnsst04,SF,20,DET,77,1,1371,129,365,.353,45,154,.292,84,211,.398,.415,36,53,.679,36,153,189,105,56,24,71,121,339
231,Tyler Johnson\johnsty01,PG,24,MIA,73,0,2178,357,824,.433,93,250,.372,264,574,.460,.490,195,254,.768,50,243,293,233,84,44,90,176,1002
232,Wesley Johnson\johnswe01,SF,29,LAC,68,3,810,73,200,.365,29,118,.246,44,82,.537,.438,11,17,.647,26,155,181,23,29,30,18,83,186
233,Nikola Jokic\jokicni01,C,21,DEN,73,59,2038,494,854,.578,45,139,.324,449,715,.628,.605,188,228,.825,212,506,718,359,61,55,171,214,1221
234,Dahntay Jones\jonesda02,SF,36,CLE,1,0,12,3,8,.375,0,2,.000,3,6,.500,.375,3,4,.750,1,1,2,1,0,0,1,1,9
235,Damian Jones\jonesda03,C,21,GSW,10,0,85,8,16,.500,0,0,,8,16,.500,.500,3,10,.300,9,14,23,0,1,4,6,15,19
236,Derrick Jones\jonesde02,SF,19,PHO,32,8,545,68,121,.562,3,11,.273,65,110,.591,.574,29,41,.707,39,40,79,12,14,13,13,63,168
237,James Jones\jonesja02,SF,36,CLE,48,2,381,44,92,.478,31,66,.470,13,26,.500,.647,13,20,.650,3,34,37,14,6,10,10,37,132
238,Terrence Jones\joneste01,PF,25,TOT,54,12,1270,231,492,.470,19,75,.253,212,417,.508,.489,103,170,.606,65,241,306,59,40,54,48,67,584
238,Terrence Jones\joneste01,PF,25,NOP,51,12,1264,231,489,.472,19,75,.253,212,414,.512,.492,103,170,.606,65,238,303,59,39,53,48,67,584
238,Terrence Jones\joneste01,PF,25,MIL,3,0,6,0,3,.000,0,0,,0,3,.000,.000,0,0,,0,3,3,0,1,1,0,0,0
239,Tyus Jones\jonesty01,PG,20,MIN,60,0,774,75,181,.414,26,73,.356,49,108,.454,.486,33,43,.767,10,57,67,156,48,5,38,50,209
240,DeAndre Jordan\jordade01,C,28,LAC,81,81,2570,412,577,.714,0,2,.000,412,575,.717,.714,205,425,.482,298,816,1114,96,51,134,115,212,1029
241,Cory Joseph\josepco01,PG,25,TOR,80,22,2003,299,661,.452,48,135,.356,251,526,.477,.489,94,122,.770,51,184,235,265,66,13,108,140,740
242,Frank Kaminsky\kaminfr01,C,23,CHO,75,16,1954,320,802,.399,116,354,.328,204,448,.455,.471,118,156,.756,57,279,336,162,46,34,76,139,874
243,Enes Kanter\kanteen01,C,24,OKC,72,0,1533,402,737,.545,5,38,.132,397,699,.568,.549,224,285,.786,195,287,482,67,32,38,123,154,1033
244,Ryan Kelly\kellyry01,PF,25,ATL,16,0,110,8,28,.286,4,10,.400,4,18,.222,.357,5,6,.833,1,17,18,8,4,5,4,5,25
245,Michael Kidd-Gilchrist\kiddgmi01,SF,23,CHO,81,81,2349,295,618,.477,1,9,.111,294,609,.483,.478,152,194,.784,156,409,565,114,81,77,56,187,743
246,Sean Kilpatrick\kilpase01,SG,27,BRK,70,24,1754,305,735,.415,105,308,.341,200,427,.468,.486,204,242,.843,22,258,280,157,45,6,135,118,919
247,Brandon Knight\knighbr03,SG,25,PHO,54,5,1140,209,525,.398,45,139,.324,164,386,.425,.441,132,154,.857,25,93,118,130,27,5,88,87,595
248,Kyle Korver\korveky01,SG,35,TOT,67,22,1753,239,515,.464,162,359,.451,77,156,.494,.621,38,42,.905,7,179,186,110,34,21,69,107,678
248,Kyle Korver\korveky01,SG,35,ATL,32,21,894,108,246,.439,65,159,.409,43,87,.494,.571,24,27,.889,0,89,89,75,23,13,40,47,305
248,Kyle Korver\korveky01,SG,35,CLE,35,1,859,131,269,.487,97,200,.485,34,69,.493,.667,14,15,.933,7,90,97,35,11,8,29,60,373
249,Kosta Koufos\koufoko01,C,27,SAC,71,62,1419,216,392,.551,0,1,.000,216,391,.552,.551,38,62,.613,118,285,403,47,36,48,61,172,470
250,Mindaugas Kuzminskas\kuzmimi01,SF,27,NYK,68,5,1016,158,369,.428,54,168,.321,104,201,.517,.501,55,68,.809,47,79,126,69,29,11,51,79,425
251,Skal Labissiere\labissk01,PF,20,SAC,33,12,612,117,218,.537,3,8,.375,114,210,.543,.544,52,74,.703,51,111,162,27,16,13,37,64,289
252,Jeremy Lamb\lambje01,SG,24,CHO,62,5,1143,226,491,.460,41,146,.281,185,345,.536,.502,110,129,.853,30,234,264,75,27,23,40,98,603
253,Nicolas Laprovittola\laproni01,PG,27,SAS,18,3,174,20,47,.426,10,27,.370,10,20,.500,.532,9,9,1.000,1,9,10,28,4,1,19,19,59
254,Joffrey Lauvergne\lauvejo01,PF-C,25,TOT,70,1,980,148,336,.440,33,98,.337,115,238,.483,.490,46,73,.630,72,179,251,70,25,6,56,83,375
254,Joffrey Lauvergne\lauvejo01,PF,25,OKC,50,0,739,111,244,.455,27,78,.346,84,166,.506,.510,37,58,.638,51,132,183,51,18,6,40,71,286
254,Joffrey Lauvergne\lauvejo01,C,25,CHI,20,1,241,37,92,.402,6,20,.300,31,72,.431,.435,9,15,.600,21,47,68,19,7,0,16,12,89
255,Zach LaVine\lavinza01,SG,21,MIN,47,47,1749,326,710,.459,120,310,.387,206,400,.515,.544,117,140,.836,19,141,160,139,41,10,85,104,889
256,Ty Lawson\lawsoty01,PG,29,SAC,69,24,1732,237,522,.454,34,118,.288,203,404,.502,.487,173,217,.797,44,135,179,334,74,6,129,119,681
257,Jake Layman\laymaja01,SF,22,POR,35,1,249,26,89,.292,13,51,.255,13,38,.342,.365,13,17,.765,6,18,24,11,9,3,11,22,78
258,Courtney Lee\leeco01,SG,31,NYK,77,74,2459,321,704,.456,108,269,.401,213,435,.490,.533,85,98,.867,53,206,259,179,81,24,69,141,835
259,David Lee\leeda02,PF,33,SAS,79,10,1477,248,420,.590,0,0,,248,420,.590,.590,80,113,.708,149,292,441,124,31,40,82,125,576
260,Alex Len\lenal01,C,23,PHO,77,34,1560,230,463,.497,3,12,.250,227,451,.503,.500,150,208,.721,156,354,510,44,38,98,102,242,613
261,Kawhi Leonard\leonaka01,SF,25,SAS,74,74,2474,636,1312,.485,147,387,.380,489,925,.529,.541,469,533,.880,80,350,430,260,133,55,154,122,1888
262,Meyers Leonard\leoname01,PF,24,POR,74,12,1222,146,378,.386,74,213,.347,72,165,.436,.484,35,40,.875,27,210,237,71,13,28,35,172,401
263,Jon Leuer\leuerjo01,PF,27,DET,75,34,1944,310,646,.480,49,167,.293,261,479,.545,.518,98,113,.867,102,300,402,111,31,26,66,145,767
264,Caris LeVert\leverca01,SF,22,BRK,57,26,1237,171,380,.450,59,184,.321,112,196,.571,.528,67,93,.720,23,165,188,110,49,8,59,91,468
265,DeAndre Liggins\liggide01,SG,28,TOT,62,19,777,55,142,.387,17,46,.370,38,96,.396,.447,25,40,.625,20,88,108,54,47,14,42,81,152
265,DeAndre Liggins\liggide01,SG,28,CLE,61,19,752,52,136,.382,17,45,.378,35,91,.385,.445,23,37,.622,17,84,101,54,45,14,42,78,144
265,DeAndre Liggins\liggide01,SG,28,DAL,1,0,25,3,6,.500,0,1,.000,3,5,.600,.500,2,3,.667,3,4,7,0,2,0,0,3,8
266,Damian Lillard\lillada01,PG,26,POR,75,75,2694,661,1488,.444,214,579,.370,447,909,.492,.516,488,545,.895,46,322,368,440,68,20,197,152,2024
267,Jeremy Lin\linje01,PG,28,BRK,36,33,883,175,400,.438,58,156,.372,117,244,.480,.510,115,141,.816,11,124,135,184,42,14,86,79,523
268,Shaun Livingston\livinsh01,PG,31,GSW,76,3,1345,173,316,.547,1,3,.333,172,313,.550,.549,42,60,.700,28,123,151,139,38,20,62,120,389
269,Shawn Long\longsh01,C,24,PHI,18,0,234,61,109,.560,7,19,.368,54,90,.600,.592,19,35,.543,41,44,85,13,9,9,13,49,148
270,Kevon Looney\looneke01,C,20,GSW,53,4,447,56,107,.523,2,9,.222,54,98,.551,.533,21,34,.618,44,80,124,29,15,17,17,64,135
271,Brook Lopez\lopezbr01,C,28,BRK,75,75,2222,555,1172,.474,134,387,.346,421,785,.536,.531,295,364,.810,121,282,403,176,38,124,184,192,1539
272,Robin Lopez\lopezro01,C,28,CHI,81,81,2271,382,775,.493,0,2,.000,382,773,.494,.493,75,104,.721,244,276,520,80,18,117,91,151,839
273,Kevin Love\loveke01,PF,28,CLE,60,60,1885,370,867,.427,145,389,.373,225,478,.471,.510,257,295,.871,148,518,666,116,53,21,122,125,1142
274,Kyle Lowry\lowryky01,PG,30,TOR,60,60,2244,426,918,.464,193,468,.412,233,450,.518,.569,299,365,.819,48,238,286,417,88,19,173,170,1344
275,John Lucas III\lucasjo02,PG,34,MIN,5,0,11,1,4,.250,0,1,.000,1,3,.333,.250,0,0,,0,0,0,1,2,0,0,0,2
276,Timothe Luwawu-Cabarrot\luwawti01,SF,21,PHI,69,19,1190,145,361,.402,50,161,.311,95,200,.475,.471,105,123,.854,25,124,149,75,32,10,73,154,445
277,Trey Lyles\lylestr01,PF,21,UTA,71,4,1158,159,439,.362,65,204,.319,94,235,.400,.436,57,79,.722,48,187,235,69,26,20,64,97,440
278,Sheldon Mac\mcclesh01,SG,24,WAS,30,3,287,30,75,.400,7,30,.233,23,45,.511,.447,23,27,.852,4,30,34,15,8,2,5,17,90
279,Shelvin Mack\macksh01,PG,26,UTA,55,9,1205,170,381,.446,37,120,.308,133,261,.510,.495,53,77,.688,20,105,125,154,42,3,90,100,430
280,Ian Mahinmi\mahinia01,C,30,WAS,31,0,555,65,111,.586,0,0,,65,111,.586,.586,43,75,.573,47,103,150,19,33,24,34,90,173
281,Thon Maker\makerth01,C,19,MIL,57,34,562,83,181,.459,28,74,.378,55,107,.514,.536,32,49,.653,40,74,114,23,10,26,17,84,226
282,Boban Marjanovic\marjabo01,C,28,DET,35,0,293,72,132,.545,0,0,,72,132,.545,.545,47,58,.810,46,84,130,9,6,12,10,25,191
283,Jarell Martin\martija01,PF,22,MEM,42,3,558,58,151,.384,9,25,.360,49,126,.389,.414,40,50,.800,42,120,162,8,17,9,28,91,165
284,Wesley Matthews\matthwe02,SG,30,DAL,73,73,2495,333,847,.393,174,479,.363,159,368,.432,.496,146,179,.816,18,241,259,210,77,15,102,161,986
285,Luc Mbah a Moute\mbahalu01,SF,30,LAC,80,76,1787,191,378,.505,43,110,.391,148,268,.552,.562,59,87,.678,44,126,170,39,81,35,46,122,484
286,James Michael McAdoo\mcadoja01,PF,24,GSW,52,2,457,62,117,.530,2,8,.250,60,109,.550,.538,21,42,.500,34,57,91,18,18,29,19,47,147
287,Patrick McCaw\mccawpa01,SG,21,GSW,71,20,1074,106,245,.433,41,123,.333,65,122,.533,.516,29,37,.784,21,79,100,77,32,15,36,62,282
288,CJ McCollum\mccolcj01,SG,25,POR,80,80,2796,692,1441,.480,185,439,.421,507,1002,.506,.544,268,294,.912,60,229,289,285,72,42,172,202,1837
289,T.J. McConnell\mccontj01,PG,24,PHI,81,51,2133,236,512,.461,11,55,.200,225,457,.492,.472,73,90,.811,39,212,251,534,134,10,159,139,556
290,Chris McCullough\mcculch01,PF,21,TOT,16,0,80,16,32,.500,1,7,.143,15,25,.600,.516,3,5,.600,9,10,19,2,2,2,3,7,36
290,Chris McCullough\mcculch01,PF,21,BRK,14,0,72,16,31,.516,1,6,.167,15,25,.600,.532,2,3,.667,9,8,17,2,1,2,2,7,35
290,Chris McCullough\mcculch01,PF,21,WAS,2,0,8,0,1,.000,0,1,.000,0,0,,.000,1,2,.500,0,2,2,0,1,0,1,0,1
291,K.J. McDaniels\mcdankj01,SF,23,TOT,49,0,505,77,169,.456,20,66,.303,57,103,.553,.515,32,38,.842,15,67,82,13,19,18,29,49,206
291,K.J. McDaniels\mcdankj01,SF,23,HOU,29,0,212,31,68,.456,9,27,.333,22,41,.537,.522,9,10,.900,6,24,30,4,7,8,10,24,80
291,K.J. McDaniels\mcdankj01,SF,23,BRK,20,0,293,46,101,.455,11,39,.282,35,62,.565,.510,23,28,.821,9,43,52,9,12,10,19,25,126
292,Doug McDermott\mcderdo01,SF,25,TOT,66,5,1508,222,497,.447,77,208,.370,145,289,.502,.524,71,84,.845,20,159,179,58,13,5,38,79,592
292,Doug McDermott\mcderdo01,SF,25,CHI,44,4,1078,166,373,.445,56,150,.373,110,223,.493,.520,59,67,.881,14,116,130,45,11,4,32,57,447
292,Doug McDermott\mcderdo01,SF,25,OKC,22,1,430,56,124,.452,21,58,.362,35,66,.530,.536,12,17,.706,6,43,49,13,2,1,6,22,145
293,JaVale McGee\mcgeeja01,C,29,GSW,77,10,739,208,319,.652,0,3,.000,208,316,.658,.652,56,111,.505,100,144,244,17,19,67,40,109,472
294,Rodney McGruder\mcgruro01,SG,25,MIA,78,65,1966,190,460,.413,73,220,.332,117,240,.488,.492,44,71,.620,94,162,256,124,46,18,56,140,497
295,Ben McLemore\mclembe01,SG,23,SAC,61,26,1176,180,419,.430,65,170,.382,115,249,.462,.507,70,93,.753,19,110,129,51,29,6,62,108,495
296,Jordan McRae\mcraejo01,SG,25,CLE,37,4,384,58,150,.387,18,51,.353,40,99,.404,.447,27,34,.794,6,35,41,19,8,6,14,31,161
297,Josh McRoberts\mcrobjo01,PF,29,MIA,22,14,381,44,118,.373,13,31,.419,31,87,.356,.428,6,9,.667,23,51,74,50,10,4,23,31,107
298,Jodie Meeks\meeksjo01,SG,29,ORL,36,10,738,103,256,.402,56,137,.409,47,119,.395,.512,65,74,.878,5,72,77,45,34,4,36,41,327
299,Salah Mejri\mejrisa01,C,30,DAL,73,11,905,88,137,.642,1,3,.333,87,134,.649,.646,36,61,.590,97,211,308,14,32,61,40,152,213
300,Jordan Mickey\mickejo01,PF,22,BOS,25,1,141,15,34,.441,0,1,.000,15,33,.455,.441,8,14,.571,13,21,34,7,3,6,9,12,38
301,Khris Middleton\middlkh01,SF,25,MIL,29,23,889,150,333,.450,45,104,.433,105,229,.459,.518,81,92,.880,11,112,123,99,41,7,65,79,426
302,C.J. Miles\milescj01,SF,29,IND,76,29,1776,281,647,.434,169,409,.413,112,238,.471,.565,84,93,.903,30,199,229,48,46,25,40,151,815
303,Mike Miller\millemi01,SF,36,DEN,20,0,151,9,23,.391,8,20,.400,1,3,.333,.565,2,2,1.000,2,36,38,22,2,0,13,9,28
304,Patty Mills\millspa02,PG,28,SAS,80,8,1754,273,621,.440,147,355,.414,126,266,.474,.558,66,80,.825,24,117,141,280,65,3,101,109,759
305,Elijah Millsap\millsel01,SG,29,PHO,2,0,23,1,7,.143,0,2,.000,1,5,.200,.143,1,2,.500,3,3,6,1,0,0,2,2,3
306,Paul Millsap\millspa01,PF,31,ATL,69,67,2343,430,972,.442,75,241,.311,355,731,.486,.481,311,405,.768,111,422,533,252,90,62,158,186,1246
307,Nikola Mirotic\mirotni01,PF,25,CHI,70,15,1679,258,625,.413,129,377,.342,129,248,.520,.516,99,128,.773,61,323,384,75,53,55,80,128,744
308,Greg Monroe\monrogr01,C,26,MIL,81,0,1823,387,726,.533,0,4,.000,387,722,.536,.533,177,239,.741,167,365,532,187,92,38,140,168,951
309,E'Twaun Moore\mooreet01,SG,27,NOP,73,22,1820,283,619,.457,77,208,.370,206,411,.501,.519,57,74,.770,33,119,152,164,50,32,62,131,700
310,Marcus Morris\morrima03,SF,27,DET,79,79,2565,421,1007,.418,118,357,.331,303,650,.466,.477,145,185,.784,77,289,366,160,52,25,87,168,1105
311,Markieff Morris\morrima02,PF,27,WAS,76,76,2374,406,889,.457,71,196,.362,335,693,.483,.497,180,215,.837,107,386,493,126,82,42,129,254,1063
312,Anthony Morrow\morroan01,SG,31,TOT,49,7,714,98,252,.389,41,133,.308,57,119,.479,.470,34,37,.919,12,19,31,25,24,2,6,44,271
312,Anthony Morrow\morroan01,SG,31,OKC,40,7,627,86,223,.386,35,119,.294,51,104,.490,.464,23,26,.885,11,18,29,19,22,2,6,40,230
312,Anthony Morrow\morroan01,SG,31,CHI,9,0,87,12,29,.414,6,14,.429,6,15,.400,.517,11,11,1.000,1,1,2,6,2,0,0,4,41
313,Donatas Motiejunas\motiedo01,PF,26,NOP,34,0,479,57,138,.413,11,47,.234,46,91,.505,.453,25,49,.510,26,75,101,32,18,11,31,55,150
314,Timofey Mozgov\mozgoti01,C,30,LAL,54,52,1104,169,328,.515,0,1,.000,169,327,.517,.515,63,78,.808,104,160,264,43,16,31,72,133,401
315,Emmanuel Mudiay\mudiaem01,PG,20,DEN,55,41,1406,208,551,.377,56,178,.315,152,373,.408,.428,131,167,.784,29,149,178,217,41,13,123,95,603
316,Shabazz Muhammad\muhamsh01,SF,24,MIN,78,1,1516,288,598,.482,49,145,.338,239,453,.528,.523,147,190,.774,84,136,220,35,22,6,56,86,772
317,Dejounte Murray\murrade01,PG,20,SAS,38,8,322,50,116,.431,9,23,.391,41,93,.441,.470,21,30,.700,6,36,42,48,8,6,38,29,130
318,Jamal Murray\murraja01,SG,19,DEN,82,10,1764,295,730,.404,115,344,.334,180,386,.466,.483,106,120,.883,41,173,214,170,51,24,113,124,811
319,Mike Muscala\muscami01,C,25,ATL,70,3,1237,170,337,.504,46,110,.418,124,227,.546,.573,49,64,.766,76,164,240,95,30,41,55,97,435
320,Larry Nance\nancela02,PF,24,LAL,63,7,1442,190,361,.526,10,36,.278,180,325,.554,.540,59,80,.738,120,249,369,96,82,39,56,149,449
321,Shabazz Napier\napiesh01,PG,25,POR,53,2,512,73,183,.399,34,92,.370,39,91,.429,.492,38,49,.776,8,53,61,67,32,2,41,38,218
322,Maurice Ndour\ndourma01,PF,24,NYK,32,4,331,39,86,.453,1,7,.143,38,79,.481,.459,19,26,.731,22,42,64,8,15,8,12,30,98
323,Gary Neal\nealga01,SG,32,ATL,2,0,18,0,7,.000,0,2,.000,0,5,.000,.000,4,4,1.000,0,1,1,1,0,0,0,1,4
324,Jameer Nelson\nelsoja01,PG,34,DEN,75,39,2045,268,604,.444,106,273,.388,162,331,.489,.531,45,63,.714,28,164,192,385,54,8,128,197,687
325,Raul Neto\netora01,PG,24,UTA,40,0,346,41,91,.451,10,31,.323,31,60,.517,.505,8,9,.889,4,26,30,34,21,5,15,48,100
326,Georges Niang\niangge01,PF,23,IND,23,0,93,9,36,.250,1,12,.083,8,24,.333,.264,2,2,1.000,2,15,17,5,3,0,5,6,21
327,Andrew Nicholson\nichoan01,PF,27,TOT,38,0,342,43,111,.387,5,27,.185,38,84,.452,.410,9,14,.643,15,46,61,10,16,6,17,55,100
327,Andrew Nicholson\nichoan01,PF,27,WAS,28,0,231,30,77,.390,3,16,.188,27,61,.443,.409,7,12,.583,11,23,34,7,11,6,11,37,70
327,Andrew Nicholson\nichoan01,PF,27,BRK,10,0,111,13,34,.382,2,11,.182,11,23,.478,.412,2,2,1.000,4,23,27,3,5,0,6,18,30
328,Joakim Noah\noahjo01,C,31,NYK,46,46,1015,99,202,.490,0,1,.000,99,201,.493,.490,34,78,.436,162,241,403,103,30,37,58,127,232
329,Nerlens Noel\noelne01,C,22,TOT,51,19,1047,184,309,.595,0,1,.000,184,308,.597,.595,77,111,.694,93,201,294,50,65,50,51,126,445
329,Nerlens Noel\noelne01,C,22,PHI,29,7,564,107,175,.611,0,1,.000,107,174,.615,.611,43,63,.683,46,98,144,30,43,26,29,71,257
329,Nerlens Noel\noelne01,C,22,DAL,22,12,483,77,134,.575,0,0,,77,134,.575,.575,34,48,.708,47,103,150,20,22,24,22,55,188
330,Lucas Nogueira\noguelu01,C,24,TOR,57,6,1088,103,156,.660,3,12,.250,100,144,.694,.670,44,67,.657,82,162,244,42,52,89,46,137,253
331,Steve Novak\novakst01,PF,33,MIL,8,0,22,2,7,.286,1,6,.167,1,1,1.000,.357,0,0,,0,3,3,0,0,0,0,1,5
332,Dirk Nowitzki\nowitdi01,PF,38,DAL,54,54,1424,296,678,.437,79,209,.378,217,469,.463,.495,98,112,.875,23,330,353,82,30,38,51,113,769
333,Jusuf Nurkic\nurkiju01,C,22,TOT,65,48,1391,271,534,.507,0,1,.000,271,533,.508,.507,120,210,.571,154,313,467,123,50,74,143,161,662
333,Jusuf Nurkic\nurkiju01,C,22,DEN,45,29,807,151,298,.507,0,0,,151,298,.507,.507,56,113,.496,89,171,260,60,25,36,81,88,358
333,Jusuf Nurkic\nurkiju01,C,22,POR,20,19,584,120,236,.508,0,1,.000,120,235,.511,.508,64,97,.660,65,142,207,63,25,38,62,73,304
334,David Nwaba\nwabada01,SG,24,LAL,20,2,397,47,81,.580,1,5,.200,46,76,.605,.586,25,39,.641,17,46,63,14,13,7,11,36,120
335,Johnny O'Bryant\obryajo01,PF,23,TOT,11,0,80,15,30,.500,3,6,.500,12,24,.500,.550,5,6,.833,9,10,19,6,0,1,6,10,38
335,Johnny O'Bryant\obryajo01,PF,23,DEN,7,0,46,7,15,.467,2,3,.667,5,12,.417,.533,4,4,1.000,5,6,11,2,0,1,3,4,20
335,Johnny O'Bryant\obryajo01,PF,23,CHO,4,0,34,8,15,.533,1,3,.333,7,12,.583,.567,1,2,.500,4,4,8,4,0,0,3,6,18
336,Kyle O'Quinn\oquinky01,C,26,NYK,79,8,1229,215,413,.521,2,17,.118,213,396,.538,.523,64,83,.771,157,282,439,117,36,104,76,174,496
337,Daniel Ochefu\ochefda01,C,23,WAS,19,0,75,12,27,.444,0,0,,12,27,.444,.444,0,2,.000,5,17,22,3,2,0,3,17,24
338,Jahlil Okafor\okafoja01,C,21,PHI,50,33,1134,242,471,.514,0,0,,242,471,.514,.514,106,158,.671,81,159,240,58,20,49,91,122,590
339,Victor Oladipo\oladivi01,SG,24,OKC,67,67,2222,412,932,.442,127,352,.361,285,580,.491,.510,116,154,.753,39,252,291,176,78,21,119,155,1067
340,Kelly Olynyk\olynyke01,C,25,BOS,75,6,1538,260,508,.512,68,192,.354,192,316,.608,.579,90,123,.732,73,288,361,148,43,29,96,207,678
341,Arinze Onuaku\onuakar01,C,29,ORL,8,0,28,2,4,.500,0,0,,2,4,.500,.500,0,0,,2,4,6,2,0,1,2,3,4
342,Chinanu Onuaku\onuakch01,C,20,HOU,5,1,52,5,7,.714,0,0,,5,7,.714,.714,4,4,1.000,2,8,10,3,3,1,4,6,14
343,Kelly Oubre\oubreke01,SF,21,WAS,79,5,1605,186,442,.421,54,188,.287,132,254,.520,.482,75,99,.758,61,200,261,47,58,17,50,195,501
344,Zaza Pachulia\pachuza01,C,32,GSW,70,70,1268,164,307,.534,0,2,.000,164,305,.538,.534,98,126,.778,140,270,410,132,59,33,87,166,426
345,Georgios Papagiannis\papagge01,C,19,SAC,22,0,355,56,102,.549,0,2,.000,56,100,.560,.549,12,14,.857,24,62,86,20,3,17,24,44,124
346,Jabari Parker\parkeja01,PF,21,MIL,51,50,1728,399,814,.490,65,178,.365,334,636,.525,.530,162,218,.743,79,235,314,142,50,22,93,111,1025
347,Tony Parker\parketo01,PG,34,SAS,63,63,1587,265,569,.466,23,69,.333,242,500,.484,.486,85,117,.726,9,104,113,285,34,2,89,92,638
348,Chandler Parsons\parsoch01,SF,28,MEM,34,34,675,75,222,.338,25,93,.269,50,129,.388,.394,35,43,.814,6,78,84,55,20,5,24,52,210
349,Lamar Patterson\pattela01,SG,25,ATL,5,0,40,3,15,.200,1,6,.167,2,9,.222,.233,2,3,.667,1,6,7,6,1,0,4,6,9
350,Patrick Patterson\pattepa01,PF,27,TOR,65,8,1599,154,384,.401,94,253,.372,60,131,.458,.523,43,60,.717,62,231,293,76,40,23,38,120,445
351,Chris Paul\paulch01,PG,31,LAC,61,61,1921,374,785,.476,124,302,.411,250,483,.518,.555,232,260,.892,40,264,304,563,119,8,147,146,1104
352,Adreian Payne\paynead01,PF,25,MIN,18,0,135,23,54,.426,3,15,.200,20,39,.513,.454,14,19,.737,9,24,33,7,8,7,8,32,63
353,Cameron Payne\payneca01,PG,22,TOT,31,0,462,64,193,.332,27,86,.314,37,107,.346,.402,5,8,.625,3,45,48,55,14,4,29,52,160
353,Cameron Payne\payneca01,PG,22,OKC,20,0,320,43,130,.331,16,52,.308,27,78,.346,.392,4,4,1.000,2,29,31,40,10,4,16,38,106
353,Cameron Payne\payneca01,PG,22,CHI,11,0,142,21,63,.333,11,34,.324,10,29,.345,.421,1,4,.250,1,16,17,15,4,0,13,14,54
354,Elfrid Payton\paytoel01,PG,22,ORL,82,58,2412,430,912,.471,40,146,.274,390,766,.509,.493,146,211,.692,89,298,387,529,88,40,178,177,1046
355,Gary Payton\paytoga02,PG,24,MIL,6,0,99,8,22,.364,1,9,.111,7,13,.538,.386,3,5,.600,0,12,12,13,3,4,10,9,20
356,Paul Pierce\piercpa01,SF,39,LAC,25,7,277,28,70,.400,15,43,.349,13,27,.481,.507,10,13,.769,1,47,48,10,4,5,16,40,81
357,Marshall Plumlee\plumlma02,C,24,NYK,21,1,170,16,30,.533,0,0,,16,30,.533,.533,8,19,.421,23,28,51,10,4,4,12,23,40
358,Mason Plumlee\plumlma01,C,26,TOT,81,64,2148,334,623,.536,0,6,.000,334,617,.541,.536,174,300,.580,170,435,605,284,69,92,134,226,842
358,Mason Plumlee\plumlma01,C,26,POR,54,54,1516,235,442,.532,0,5,.000,235,437,.538,.532,127,224,.567,120,312,432,214,50,63,88,149,597
358,Mason Plumlee\plumlma01,C,26,DEN,27,10,632,99,181,.547,0,1,.000,99,180,.550,.547,47,76,.618,50,123,173,70,19,29,46,77,245
359,Miles Plumlee\plumlmi01,C,28,TOT,45,12,484,44,92,.478,0,0,,44,92,.478,.478,25,39,.641,38,57,95,21,18,13,30,73,113
359,Miles Plumlee\plumlmi01,C,28,MIL,32,12,310,30,68,.441,0,0,,30,68,.441,.441,22,35,.629,23,30,53,18,11,9,22,48,82
359,Miles Plumlee\plumlmi01,C,28,CHO,13,0,174,14,24,.583,0,0,,14,24,.583,.583,3,4,.750,15,27,42,3,7,4,8,25,31
360,Jakob Poeltl\poeltja01,C,21,TOR,54,4,626,67,115,.583,0,0,,67,115,.583,.583,31,57,.544,78,87,165,12,17,20,29,113,165
361,Otto Porter\porteot01,SF,23,WAS,80,80,2605,414,803,.516,148,341,.434,266,462,.576,.608,99,119,.832,118,396,514,121,116,42,44,193,1075
362,Bobby Portis\portibo01,PF,21,CHI,64,13,1000,183,375,.488,32,96,.333,151,279,.541,.531,39,59,.661,75,221,296,35,16,11,37,94,437
363,Kristaps Porzingis\porzikr01,PF,21,NYK,66,65,2164,443,985,.450,112,314,.357,331,671,.493,.507,198,252,.786,111,364,475,97,47,129,118,244,1196
364,Dwight Powell\poweldw01,C,25,DAL,77,3,1333,194,377,.515,21,74,.284,173,303,.571,.542,107,141,.759,93,213,306,49,61,39,34,135,516
365,Norman Powell\powelno01,SG,23,TOR,76,18,1368,227,506,.449,56,173,.324,171,333,.514,.504,126,159,.792,26,143,169,82,52,14,70,127,636
366,Alex Poythress\poythal01,PF,23,PHI,6,1,157,25,54,.463,6,19,.316,19,35,.543,.519,8,10,.800,11,18,29,5,3,2,3,14,64
367,Ronnie Price\pricero01,PG,33,PHO,14,0,134,4,24,.167,3,17,.176,1,7,.143,.229,3,4,.750,3,8,11,18,11,1,3,14,14
368,Tim Quarterman\quartti01,SG,22,POR,16,0,80,13,29,.448,5,13,.385,8,16,.500,.534,0,3,.000,4,10,14,11,2,3,11,6,31
369,Chasson Randle\randlch01,PG,23,TOT,26,0,299,40,98,.408,16,47,.340,24,51,.471,.490,41,43,.953,6,26,32,34,9,2,19,39,137
369,Chasson Randle\randlch01,PG,23,PHI,8,0,74,12,26,.462,6,15,.400,6,11,.545,.577,12,12,1.000,0,5,5,6,3,1,3,11,42
369,Chasson Randle\randlch01,PG,23,NYK,18,0,225,28,72,.389,10,32,.313,18,40,.450,.458,29,31,.935,6,21,27,28,6,1,16,28,95
370,Julius Randle\randlju01,PF,22,LAL,74,73,2132,377,773,.488,17,63,.270,360,710,.507,.499,204,282,.723,150,486,636,264,49,37,173,248,975
371,Zach Randolph\randoza01,PF,35,MEM,73,5,1786,433,964,.449,21,94,.223,412,870,.474,.460,141,193,.731,182,416,598,122,38,10,99,136,1028
372,J.J. Redick\redicjj01,SG,32,LAC,78,78,2198,396,890,.445,201,468,.429,195,422,.462,.558,180,202,.891,11,160,171,110,54,13,98,125,1173
373,Willie Reed\reedwi02,C,26,MIA,71,5,1031,162,285,.568,1,4,.250,161,281,.573,.570,49,88,.557,129,203,332,26,18,47,31,137,374
374,Josh Richardson\richajo01,SG,23,MIA,53,34,1614,202,513,.394,75,227,.330,127,286,.444,.467,60,77,.779,35,133,168,140,60,39,65,132,539
375,Malachi Richardson\richama01,SG,21,SAC,22,0,198,28,68,.412,8,28,.286,20,40,.500,.471,15,19,.789,3,20,23,11,5,1,8,23,79
376,Austin Rivers\riverau01,SG,24,LAC,74,29,2054,323,731,.442,111,299,.371,212,432,.491,.518,132,191,.691,20,141,161,204,48,10,115,187,889
377,Andre Roberson\roberan03,SF,25,OKC,79,79,2376,215,463,.464,45,184,.245,170,279,.609,.513,47,111,.423,98,305,403,79,94,79,51,204,522
378,Brian Roberts\roberbr01,PG,31,CHO,41,2,416,46,122,.377,17,44,.386,29,78,.372,.447,33,39,.846,5,34,39,52,9,1,26,18,142
379,Glenn Robinson\robingl02,SF,23,IND,69,27,1427,158,338,.467,49,125,.392,109,213,.512,.540,54,76,.711,57,189,246,47,41,20,37,63,419
380,Thomas Robinson\robinth01,PF,25,LAL,48,1,560,105,196,.536,0,1,.000,105,195,.538,.536,31,66,.470,84,139,223,31,26,9,46,76,241
381,Sergio Rodriguez\rodrise01,PG,30,PHI,68,30,1518,210,536,.392,92,252,.365,118,284,.415,.478,18,27,.667,21,136,157,344,49,4,128,95,530
382,Rajon Rondo\rondora01,PG,30,CHI,69,42,1843,229,561,.408,50,133,.376,179,428,.418,.453,30,50,.600,73,282,355,461,99,11,169,144,538
383,Derrick Rose\rosede01,PG,28,NYK,64,64,2082,460,977,.471,13,60,.217,447,917,.487,.477,221,253,.874,66,180,246,283,44,17,147,84,1154
384,Terrence Ross\rosste01,SF,25,TOT,78,24,1955,326,746,.437,142,391,.363,184,355,.518,.532,64,77,.831,18,188,206,88,87,33,68,143,858
384,Terrence Ross\rosste01,SF,25,TOR,54,0,1207,211,479,.441,96,256,.375,115,223,.516,.541,41,50,.820,14,124,138,45,53,20,33,82,559
384,Terrence Ross\rosste01,SF,25,ORL,24,24,748,115,267,.431,46,135,.341,69,132,.523,.517,23,27,.852,4,64,68,43,34,13,35,61,299
385,Terry Rozier\roziete01,PG,22,BOS,74,0,1263,151,411,.367,57,179,.318,94,232,.405,.437,51,66,.773,40,187,227,131,46,11,47,69,410
386,Ricky Rubio\rubiori01,PG,26,MIN,75,75,2469,261,650,.402,60,196,.306,201,454,.443,.448,254,285,.891,68,237,305,682,128,10,195,202,836
387,Damjan Rudez\rudezda01,SF,30,ORL,45,0,314,31,88,.352,20,64,.313,11,24,.458,.466,0,0,,5,20,25,20,12,1,9,31,82
388,Brandon Rush\rushbr01,SG,31,MIN,47,33,1030,70,187,.374,44,114,.386,26,73,.356,.492,13,18,.722,16,83,99,45,22,23,28,42,197
389,D'Angelo Russell\russeda01,PG,20,LAL,63,60,1811,351,867,.405,135,384,.352,216,483,.447,.483,147,188,.782,31,190,221,303,87,16,176,130,984
390,Domantas Sabonis\sabondo01,PF,20,OKC,81,66,1632,192,481,.399,51,159,.321,141,322,.438,.452,44,67,.657,46,242,288,82,39,32,83,200,479
391,Larry Sanders\sandela01,C,28,CLE,5,0,13,1,4,.250,0,0,,1,4,.250,.250,2,2,1.000,3,1,4,0,1,1,2,5,4
392,Dario Saric\saricda01,PF,22,PHI,81,36,2129,381,927,.411,106,341,.311,275,586,.469,.468,172,220,.782,112,401,513,182,57,30,183,162,1040
393,Tomas Satoransky\satorto01,SG,25,WAS,57,3,719,61,147,.415,9,37,.243,52,110,.473,.446,23,33,.697,25,58,83,92,26,6,38,60,154
394,Dennis Schroder\schrode01,PG,23,ATL,79,78,2485,548,1214,.451,100,294,.340,448,920,.487,.493,218,255,.855,42,206,248,499,74,16,258,149,1414
395,Luis Scola\scolalu01,PF,36,BRK,36,1,461,71,151,.470,17,50,.340,54,101,.535,.526,25,37,.676,51,88,139,37,14,4,34,63,184
396,Mike Scott\scottmi01,PF,28,ATL,18,0,195,17,59,.288,4,27,.148,13,32,.406,.322,7,8,.875,10,27,37,17,4,3,8,12,45
397,Thabo Sefolosha\sefolth01,SF,32,ATL,62,42,1596,174,395,.441,41,120,.342,133,275,.484,.492,55,75,.733,54,216,270,107,96,31,58,97,444
398,Wayne Selden\seldewa01,SG,22,TOT,14,5,236,25,58,.431,7,28,.250,18,30,.600,.491,14,22,.636,1,15,16,13,6,1,12,18,71
398,Wayne Selden\seldewa01,SG,22,NOP,3,3,47,5,8,.625,4,7,.571,1,1,1.000,.875,2,4,.500,0,5,5,1,2,0,3,6,16
398,Wayne Selden\seldewa01,SG,22,MEM,11,2,189,20,50,.400,3,21,.143,17,29,.586,.430,12,18,.667,1,10,11,12,4,1,9,12,55
399,Kevin Seraphin\serapke01,PF,27,IND,49,3,559,109,198,.551,0,2,.000,109,196,.556,.551,14,22,.636,41,101,142,23,7,20,29,66,232
400,Ramon Sessions\sessira01,PG,30,CHO,50,1,811,100,263,.380,21,62,.339,79,201,.393,.420,91,118,.771,11,62,73,129,27,3,46,43,312
401,Iman Shumpert\shumpim01,SG,26,CLE,76,31,1937,201,489,.411,94,261,.360,107,228,.469,.507,71,90,.789,39,179,218,109,62,27,78,150,567
402,Pascal Siakam\siakapa01,PF,22,TOR,55,38,859,103,205,.502,1,7,.143,102,198,.515,.505,22,32,.688,64,121,185,17,26,45,33,109,229
403,Jonathon Simmons\simmojo02,SG,27,SAS,78,8,1392,177,421,.420,30,102,.294,147,319,.461,.456,99,132,.750,20,140,160,126,47,25,76,146,483
404,Kyle Singler\singlky01,SF,28,OKC,32,2,385,34,83,.410,7,37,.189,27,46,.587,.452,13,17,.765,8,40,48,9,7,5,11,29,88
405,Marcus Smart\smartma01,SG,22,BOS,79,24,2399,269,749,.359,94,332,.283,175,417,.420,.422,203,250,.812,78,227,305,364,125,34,159,192,835
406,Ish Smith\smithis01,PG,28,DET,81,32,1955,329,749,.439,28,105,.267,301,644,.467,.458,72,102,.706,21,214,235,418,61,33,112,127,758
407,J.R. Smith\smithjr01,SG,31,CLE,41,35,1187,123,356,.346,95,271,.351,28,85,.329,.479,10,15,.667,17,96,113,62,40,11,26,77,351
408,Jason Smith\smithja02,C,30,WAS,74,3,1068,174,329,.529,37,78,.474,137,251,.546,.585,35,51,.686,64,194,258,37,21,54,58,168,420
409,Tony Snell\snellto01,SG,25,MIL,80,80,2336,246,541,.455,144,355,.406,102,186,.548,.588,47,58,.810,22,226,248,96,55,14,55,125,683
410,Marreese Speights\speigma01,C,29,LAC,82,2,1286,244,548,.445,103,277,.372,141,271,.520,.539,120,137,.876,88,285,373,65,23,41,69,229,711
411,Tiago Splitter\splitti01,C,32,PHI,8,0,76,14,31,.452,2,6,.333,12,25,.480,.484,9,11,.818,8,14,22,4,1,1,6,8,39
412,Nik Stauskas\stausni01,SG,23,PHI,80,27,2188,251,634,.396,132,359,.368,119,275,.433,.500,122,150,.813,21,205,226,188,45,32,128,144,756
413,Lance Stephenson\stephla01,SG,26,TOT,18,0,361,54,120,.450,6,20,.300,48,100,.480,.475,8,13,.615,4,48,52,59,5,3,26,32,122
413,Lance Stephenson\stephla01,SG,26,NOP,6,0,162,26,55,.473,1,10,.100,25,45,.556,.482,5,8,.625,3,15,18,29,2,1,11,18,58
413,Lance Stephenson\stephla01,SG,26,MIN,6,0,67,10,21,.476,0,2,.000,10,19,.526,.476,1,2,.500,0,10,10,5,0,0,4,2,21
413,Lance Stephenson\stephla01,SG,26,IND,6,0,132,18,44,.409,5,8,.625,13,36,.361,.466,2,3,.667,1,23,24,25,3,2,11,12,43
414,Jarnell Stokes\stokeja01,C,23,DEN,2,0,7,1,1,1.000,0,0,,1,1,1.000,1.000,1,2,.500,1,1,2,2,1,0,0,3,3
415,Diamond Stone\stonedi01,C,19,LAC,7,0,24,3,13,.231,0,0,,3,13,.231,.231,4,4,1.000,1,5,6,0,0,1,2,5,10
416,Rodney Stuckey\stuckro01,PG,30,IND,39,0,696,91,244,.373,19,60,.317,72,184,.391,.412,80,107,.748,6,78,84,84,16,0,53,44,281
417,Jared Sullinger\sullija01,PF,24,TOR,11,1,118,15,47,.319,3,18,.167,12,29,.414,.351,4,8,.500,10,17,27,3,4,1,4,17,37
418,Edy Tavares\tavarwa01,C,24,TOT,2,0,28,4,5,.800,0,0,,4,5,.800,.800,0,3,.000,4,7,11,1,0,6,2,3,8
418,Edy Tavares\tavarwa01,C,24,ATL,1,0,4,1,1,1.000,0,0,,1,1,1.000,1.000,0,2,.000,0,1,1,0,0,0,0,0,2
418,Edy Tavares\tavarwa01,C,24,CLE,1,0,24,3,4,.750,0,0,,3,4,.750,.750,0,1,.000,4,6,10,1,0,6,2,3,6
419,Isaiah Taylor\taylois01,PG,22,HOU,4,0,52,1,7,.143,0,2,.000,1,5,.200,.143,1,2,.500,1,2,3,3,1,1,0,6,3
420,Jeff Teague\teaguje01,PG,28,IND,82,82,2657,402,909,.442,90,252,.357,312,657,.475,.492,360,415,.867,33,297,330,639,100,32,216,165,1254
421,Mirza Teletovic\teletmi01,PF,31,MIL,70,2,1133,156,418,.373,104,305,.341,52,113,.460,.498,35,45,.778,11,151,162,48,12,13,37,109,451
422,Garrett Temple\templga01,SG,30,SAC,65,21,1728,183,432,.424,82,220,.373,101,212,.476,.519,58,74,.784,32,152,184,168,84,28,78,141,506
423,Jason Terry\terryja01,SG,39,MIL,74,0,1365,105,243,.432,73,171,.427,32,72,.444,.582,24,29,.828,15,91,106,98,46,20,36,95,307
424,Isaiah Thomas\thomais02,PG,27,BOS,76,76,2569,682,1473,.463,245,646,.379,437,827,.528,.546,590,649,.909,43,162,205,448,70,13,210,167,2199
425,Lance Thomas\thomala01,PF,28,NYK,46,15,968,97,244,.398,38,85,.447,59,159,.371,.475,43,51,.843,32,110,142,35,21,5,25,85,275
426,Hollis Thompson\thompho01,SG,25,TOT,40,9,752,77,200,.385,32,95,.337,45,105,.429,.465,19,29,.655,19,93,112,35,20,6,11,69,205
426,Hollis Thompson\thompho01,SG,25,PHI,31,1,561,66,159,.415,26,71,.366,40,88,.455,.497,13,20,.650,15,69,84,26,14,6,9,55,171
426,Hollis Thompson\thompho01,SG,25,NOP,9,8,191,11,41,.268,6,24,.250,5,17,.294,.341,6,9,.667,4,24,28,9,6,0,2,14,34
427,Klay Thompson\thompkl01,SG,26,GSW,78,78,2649,644,1376,.468,268,647,.414,376,729,.516,.565,186,218,.853,49,236,285,160,66,40,128,139,1742
428,Tristan Thompson\thomptr01,C,25,CLE,78,78,2336,262,437,.600,0,3,.000,262,434,.604,.600,106,213,.498,286,429,715,77,39,84,64,176,630
429,Marcus Thornton\thornma01,SG,29,WAS,33,1,575,84,210,.400,28,80,.350,56,130,.431,.467,23,27,.852,22,54,76,41,19,3,25,48,219
430,Mike Tobey\tobeymi01,C,22,CHO,2,0,25,1,4,.250,0,0,,1,4,.250,.250,0,0,,2,1,3,1,0,0,1,2,2
431,Anthony Tolliver\tollian01,PF,31,SAC,65,9,1477,155,351,.442,90,230,.391,65,121,.537,.570,61,82,.744,51,186,237,77,34,20,56,109,461
432,Axel Toupane\toupaax01,SF,24,TOT,4,0,47,5,9,.556,1,4,.250,4,5,.800,.611,0,0,,0,1,1,0,1,1,0,6,11
432,Axel Toupane\toupaax01,SF,24,MIL,2,0,6,0,1,.000,0,1,.000,0,0,,.000,0,0,,0,0,0,0,0,0,0,1,0
432,Axel Toupane\toupaax01,SF,24,NOP,2,0,41,5,8,.625,1,3,.333,4,5,.800,.688,0,0,,0,1,1,0,1,1,0,5,11
433,Karl-Anthony Towns\townska01,C,21,MIN,82,82,3030,802,1480,.542,101,275,.367,701,1205,.582,.576,356,428,.832,296,711,1007,220,56,103,212,241,2061
434,P.J. Tucker\tuckepj01,SF,31,TOT,81,21,2236,199,482,.413,70,196,.357,129,286,.451,.485,72,93,.774,117,354,471,99,116,19,66,196,540
434,P.J. Tucker\tuckepj01,SF,31,PHO,57,17,1627,147,354,.415,46,136,.338,101,218,.463,.480,61,77,.792,94,248,342,73,85,14,52,143,401
434,P.J. Tucker\tuckepj01,SF,31,TOR,24,4,609,52,128,.406,24,60,.400,28,68,.412,.500,11,16,.688,23,106,129,26,31,5,14,53,139
435,Evan Turner\turneev01,SF,28,POR,65,12,1658,235,552,.426,31,118,.263,204,434,.470,.454,85,103,.825,36,211,247,205,53,24,100,121,586
436,Myles Turner\turnemy01,C,20,IND,81,81,2541,444,869,.511,40,115,.348,404,754,.536,.534,245,303,.809,139,450,589,106,74,172,105,262,1173
437,Beno Udrih\udrihbe01,PG,34,DET,39,0,560,92,197,.467,11,32,.344,81,165,.491,.495,32,34,.941,6,51,57,131,13,0,36,29,227
438,Tyler Ulis\ulisty01,PG,21,PHO,61,15,1123,184,437,.421,21,79,.266,163,358,.455,.445,55,71,.775,20,75,95,226,48,5,77,73,444
439,Jarrod Uthoff\uthofja01,PF,23,DAL,9,0,115,16,38,.421,3,9,.333,13,29,.448,.461,5,7,.714,8,14,22,9,2,4,3,8,40
440,Jonas Valanciunas\valanjo01,C,24,TOR,80,80,2066,391,702,.557,1,2,.500,390,700,.557,.558,176,217,.811,226,533,759,57,37,63,106,216,959
441,Denzel Valentine\valende01,SG,23,CHI,57,0,976,102,288,.354,73,208,.351,29,80,.363,.481,14,18,.778,11,140,151,63,30,7,49,86,291
442,Fred VanVleet\vanvlfr01,PG,22,TOR,37,0,294,39,111,.351,11,29,.379,28,82,.341,.401,18,22,.818,4,38,42,35,16,3,15,36,107
443,Anderson Varejao\varejan01,C,34,GSW,14,1,92,5,14,.357,0,0,,5,14,.357,.357,8,11,.727,12,15,27,10,3,3,8,16,18
444,Greivis Vasquez\vasqugr01,PG,30,BRK,3,0,39,2,8,.250,1,3,.333,1,5,.200,.313,2,3,.667,0,2,2,5,1,1,1,6,7
445,Rashad Vaughn\vaughra01,SG,20,MIL,41,2,458,57,156,.365,26,81,.321,31,75,.413,.449,2,5,.400,4,45,49,23,19,10,14,32,142
446,Noah Vonleh\vonleno01,PF,21,POR,74,41,1265,130,270,.481,7,20,.350,123,250,.492,.494,60,94,.638,131,256,387,31,30,27,64,154,327
447,Nikola Vucevic\vucevni01,C,26,ORL,75,55,2163,483,1031,.468,23,75,.307,460,956,.481,.480,107,160,.669,176,603,779,208,76,74,117,180,1096
448,Sasha Vujacic\vujacsa01,SG,32,NYK,42,4,408,42,136,.309,23,74,.311,19,62,.306,.393,17,24,.708,12,47,59,52,13,2,16,38,124
449,Dwyane Wade\wadedw01,SG,35,CHI,60,59,1792,414,955,.434,45,145,.310,369,810,.456,.457,223,281,.794,63,207,270,228,86,41,138,112,1096
450,Dion Waiters\waitedi01,SG,25,MIA,46,43,1384,281,663,.424,85,215,.395,196,448,.438,.488,82,127,.646,18,135,153,200,42,20,103,95,729
451,Kemba Walker\walkeke02,PG,26,CHO,79,79,2739,643,1449,.444,240,602,.399,403,847,.476,.527,304,359,.847,45,263,308,434,85,22,168,119,1830
452,John Wall\walljo01,PG,26,WAS,78,78,2836,647,1435,.451,89,272,.327,558,1163,.480,.482,422,527,.801,59,267,326,831,157,49,322,151,1805
453,Taurean Waller-Prince\princta02,SF,22,ATL,59,10,981,114,285,.400,33,102,.324,81,183,.443,.458,74,94,.787,25,132,157,55,43,27,61,96,335
454,T.J. Warren\warretj01,SF,23,PHO,66,59,2048,403,814,.495,26,98,.265,377,716,.527,.511,119,154,.773,125,214,339,75,76,39,57,175,951
455,C.J. Watson\watsocj01,PG,32,ORL,62,9,1012,96,248,.387,32,105,.305,64,143,.448,.452,57,66,.864,16,73,89,114,43,2,47,84,281
456,Briante Weber\weberbr01,PG,24,TOT,20,0,205,25,60,.417,1,10,.100,24,50,.480,.425,11,16,.688,8,18,26,21,12,1,8,16,62
456,Briante Weber\weberbr01,PG,24,GSW,7,0,46,5,14,.357,0,3,.000,5,11,.455,.357,2,3,.667,0,4,4,5,3,1,3,4,12
456,Briante Weber\weberbr01,PG,24,CHO,13,0,159,20,46,.435,1,7,.143,19,39,.487,.446,9,13,.692,8,14,22,16,9,0,5,12,50
457,David West\westda01,C,36,GSW,68,0,854,135,252,.536,3,8,.375,132,244,.541,.542,43,56,.768,47,156,203,151,42,48,78,105,316
458,Russell Westbrook\westbru01,PG,28,OKC,81,81,2802,824,1941,.425,200,583,.343,624,1358,.459,.476,710,840,.845,137,727,864,840,132,31,438,190,2558
459,Okaro White\whiteok01,PF,24,MIA,35,0,471,33,87,.379,12,34,.353,21,53,.396,.448,20,22,.909,25,57,82,21,10,10,18,52,98
460,Isaiah Whitehead\whiteis01,PG,21,BRK,73,26,1643,204,508,.402,44,149,.295,160,359,.446,.445,91,113,.805,32,152,184,192,42,36,142,175,543
461,Hassan Whiteside\whiteha01,C,27,MIA,77,77,2513,542,973,.557,0,0,,542,973,.557,.557,225,358,.628,293,795,1088,57,57,161,154,226,1309
462,Andrew Wiggins\wiggian01,SF,21,MIN,82,82,3048,709,1570,.452,103,289,.356,606,1281,.473,.484,412,542,.760,102,226,328,189,82,30,187,183,1933
463,C.J. Wilcox\wilcocj01,SG,26,ORL,22,0,108,8,31,.258,3,15,.200,5,16,.313,.306,2,2,1.000,4,8,12,12,2,1,6,8,21
464,Alan Williams\willial03,C,24,PHO,47,0,708,138,267,.517,0,1,.000,138,266,.519,.517,70,112,.625,94,198,292,23,27,32,37,125,346
465,Deron Williams\willide01,PG,32,TOT,64,44,1657,263,600,.438,85,234,.363,178,366,.486,.509,90,109,.826,14,133,147,360,31,8,138,138,701
465,Deron Williams\willide01,PG,32,DAL,40,40,1171,195,453,.430,63,181,.348,132,272,.485,.500,69,84,.821,13,89,102,274,25,2,98,96,522
465,Deron Williams\willide01,PG,32,CLE,24,4,486,68,147,.463,22,53,.415,46,94,.489,.537,21,25,.840,1,44,45,86,6,6,40,42,179
466,Derrick Williams\willide02,PF,25,TOT,50,11,804,108,244,.443,30,97,.309,78,147,.531,.504,58,89,.652,19,111,130,28,14,7,28,60,304
466,Derrick Williams\willide02,PF,25,MIA,25,11,377,54,137,.394,9,45,.200,45,92,.489,.427,31,50,.620,16,57,73,14,9,5,14,33,148
466,Derrick Williams\willide02,PF,25,CLE,25,0,427,54,107,.505,21,52,.404,33,55,.600,.603,27,39,.692,3,54,57,14,5,2,14,27,156
467,Lou Williams\willilo02,SG,30,TOT,81,1,1994,428,998,.429,163,446,.365,265,552,.480,.511,402,457,.880,26,176,202,239,80,20,160,92,1421
467,Lou Williams\willilo02,SG,30,LAL,58,1,1403,326,734,.444,122,317,.385,204,417,.489,.527,304,344,.884,14,118,132,183,65,11,120,67,1078
467,Lou Williams\willilo02,SG,30,HOU,23,0,591,102,264,.386,41,129,.318,61,135,.452,.464,98,113,.867,12,58,70,56,15,9,40,25,343
468,Marvin Williams\willima02,PF,30,CHO,76,76,2295,297,704,.422,124,354,.350,173,350,.494,.510,131,150,.873,89,411,500,106,58,53,60,134,849
469,Reggie Williams\willire02,SF,30,NOP,6,0,79,8,23,.348,5,11,.455,3,12,.250,.457,6,7,.857,2,4,6,4,3,0,0,2,27
470,Troy Williams\willitr02,SF,22,TOT,30,16,557,73,167,.437,18,62,.290,55,105,.524,.491,21,32,.656,15,54,69,25,27,10,32,60,185
470,Troy Williams\willitr02,SF,22,MEM,24,13,418,51,123,.415,10,41,.244,41,82,.500,.455,15,25,.600,6,39,45,19,24,9,26,42,127
470,Troy Williams\willitr02,SF,22,HOU,6,3,139,22,44,.500,8,21,.381,14,23,.609,.591,6,7,.857,9,15,24,6,3,1,6,18,58
471,Kyle Wiltjer\wiltjky01,PF,24,HOU,14,0,44,4,14,.286,4,13,.308,0,1,.000,.429,1,2,.500,4,6,10,2,3,1,5,4,13
472,Justise Winslow\winslju01,SF,20,MIA,18,15,625,80,225,.356,7,35,.200,73,190,.384,.371,29,47,.617,23,71,94,66,26,6,33,52,196
473,Jeff Withey\witheje01,C,26,UTA,51,1,432,55,103,.534,0,1,.000,55,102,.539,.534,36,48,.750,52,69,121,7,16,32,14,52,146
474,Christian Wood\woodch01,PF,21,CHO,13,0,107,12,23,.522,0,5,.000,12,18,.667,.522,11,15,.733,14,15,29,2,3,6,7,11,35
475,Metta World Peace\artesro01,SF,37,LAL,25,2,160,19,68,.279,9,38,.237,10,30,.333,.346,10,16,.625,5,15,20,11,10,2,7,18,57
476,Brandan Wright\wrighbr03,PF,29,MEM,28,5,447,83,135,.615,0,1,.000,83,134,.619,.615,23,35,.657,31,47,78,15,11,20,10,42,189
477,Delon Wright\wrighde01,PG,24,TOR,27,0,446,49,116,.422,10,30,.333,39,86,.453,.466,42,55,.764,16,32,48,57,27,11,25,31,150
478,James Young\youngja01,SG,21,BOS,29,0,220,25,58,.431,12,35,.343,13,23,.565,.534,6,9,.667,6,20,26,4,10,2,4,15,68
479,Joe Young\youngjo01,PG,24,IND,33,0,135,26,72,.361,5,23,.217,21,49,.429,.396,11,15,.733,1,16,17,15,4,0,5,5,68
480,Nick Young\youngni01,SG,31,LAL,60,60,1556,272,633,.430,170,421,.404,102,212,.481,.564,77,90,.856,25,113,138,58,37,14,36,137,791
481,Thaddeus Young\youngth01,PF,28,IND,74,74,2237,362,687,.527,45,118,.381,317,569,.557,.560,45,86,.523,131,317,448,122,113,29,95,135,814
482,Cody Zeller\zelleco01,C,24,CHO,62,58,1725,253,443,.571,0,1,.000,253,442,.572,.571,133,196,.679,135,270,405,99,62,58,65,189,639
483,Tyler Zeller\zellety01,C,27,BOS,51,5,525,78,158,.494,0,1,.000,78,157,.497,.494,22,39,.564,43,81,124,42,7,21,20,61,178
484,Stephen Zimmerman\zimmest01,C,20,ORL,19,0,108,10,31,.323,0,0,,10,31,.323,.323,3,5,.600,11,24,35,4,2,5,3,17,23
485,Paul Zipser\zipsepa01,SF,22,CHI,44,18,843,88,221,.398,33,99,.333,55,122,.451,.473,31,40,.775,15,110,125,36,15,16,40,78,240
486,Ivica Zubac\zubaciv01,C,19,LAL,38,11,609,126,238,.529,0,3,.000,126,235,.536,.529,32,49,.653,41,118,159,30,14,33,30,66,284
