Rk,Player,Pos,Age,Tm,G,GS,MP,FG,FGA,FG%,3P,3PA,3P%,2P,2PA,2P%,eFG%,FT,FTA,FT%,ORB,DRB,TRB,AST,STL,BLK,TOV,PF,PTS
1,Quincy Acy\acyqu01,SF,23,TOT,63,0,847,66,141,.468,4,15,.267,62,126,.492,.482,35,53,.660,72,144,216,28,23,26,30,122,171
1,Quincy Acy\acyqu01,SF,23,TOR,7,0,61,6,14,.429,2,5,.400,4,9,.444,.500,5,8,.625,5,10,15,4,4,3,2,8,19
1,Quincy Acy\acyqu01,SF,23,SAC,56,0,786,60,127,.472,2,10,.200,58,117,.496,.480,30,45,.667,67,134,201,24,19,23,28,114,152
2,Steven Adams\adamsst01,C,20,OKC,81,20,1197,93,185,.503,0,0,,93,185,.503,.503,79,136,.581,142,190,332,43,40,57,71,203,265
3,Jeff Adrien\adrieje01,PF,27,TOT,53,12,961,143,275,.520,0,0,,143,275,.520,.520,76,119,.639,102,204,306,38,24,36,39,108,362
3,Jeff Adrien\adrieje01,PF,27,CHA,25,0,256,22,40,.550,0,0,,22,40,.550,.550,13,25,.520,33,55,88,7,7,15,8,35,57
3,Jeff Adrien\adrieje01,PF,27,MIL,28,12,705,121,235,.515,0,0,,121,235,.515,.515,63,94,.670,69,149,218,31,17,21,31,73,305
4,Arron Afflalo\afflaar01,SG,28,ORL,73,73,2552,464,1011,.459,128,300,.427,336,711,.473,.522,274,336,.815,32,230,262,248,35,3,146,136,1330
5,Alexis Ajinca\ajincal01,C,25,NOP,56,30,951,136,249,.546,0,1,.000,136,248,.548,.546,56,67,.836,94,183,277,40,23,46,63,187,328
6,Cole Aldrich\aldrico01,C,25,NYK,46,2,330,33,61,.541,0,0,,33,61,.541,.541,26,30,.867,37,92,129,14,8,30,18,40,92
7,LaMarcus Aldridge\aldrila01,PF,28,POR,69,69,2498,652,1423,.458,3,15,.200,649,1408,.461,.459,296,360,.822,166,599,765,178,63,68,123,147,1603
8,Lavoy Allen\allenla01,PF,24,TOT,65,2,1072,134,300,.447,2,13,.154,132,287,.460,.450,33,50,.660,119,192,311,71,24,33,44,126,303
8,Lavoy Allen\allenla01,PF,24,PHI,51,2,960,117,266,.440,2,13,.154,115,253,.455,.444,27,40,.675,106,171,277,65,22,27,40,115,263
8,Lavoy Allen\allenla01,PF,24,IND,14,0,112,17,34,.500,0,0,,17,34,.500,.500,6,10,.600,13,21,34,6,2,6,4,11,40
9,Ray Allen*\allenra02,SG,38,MIA,73,9,1936,240,543,.442,116,309,.375,124,234,.530,.549,105,116,.905,23,182,205,143,54,8,84,115,701
10,Tony Allen\allento01,SG,32,MEM,55,28,1278,204,413,.494,11,47,.234,193,366,.527,.507,76,121,.628,79,129,208,94,90,19,90,121,495
11,Al-Farouq Aminu\aminual01,SF,23,NOP,80,65,2045,234,494,.474,13,48,.271,221,446,.496,.487,91,137,.664,129,367,496,114,82,38,88,147,572
12,Lou Amundson\amundlo01,PF,31,TOT,19,0,185,16,32,.500,0,0,,16,32,.500,.500,6,24,.250,28,27,55,6,9,11,14,49,38
12,Lou Amundson\amundlo01,PF,31,NOP,18,0,184,16,32,.500,0,0,,16,32,.500,.500,6,24,.250,28,27,55,6,9,11,14,49,38
12,Lou Amundson\amundlo01,PF,31,CHI,1,0,1,0,0,,0,0,,0,0,,,0,0,,0,0,0,0,0,0,0,0,0
13,Chris Andersen\anderch01,C,35,MIA,72,0,1396,177,275,.644,3,12,.250,174,263,.662,.649,120,169,.710,129,250,379,19,32,97,53,162,477
14,Alan Anderson\anderal01,SF,31,BRK,78,26,1773,194,485,.400,84,248,.339,110,237,.464,.487,92,118,.780,40,135,175,81,48,11,62,147,564
15,James Anderson\anderja01,SG,24,PHI,80,62,2309,309,717,.431,115,351,.328,194,366,.530,.511,77,106,.726,59,241,300,149,74,28,106,154,810
16,Ryan Anderson\anderry01,PF,25,NOP,22,14,795,155,354,.438,67,164,.409,88,190,.463,.532,59,62,.952,66,76,142,17,10,7,20,47,436
17,Giannis Antetokounmpo\antetgi01,SF,19,MIL,77,23,1897,173,418,.414,41,118,.347,132,300,.440,.463,138,202,.683,78,261,339,150,60,61,122,173,525
18,Carmelo Anthony\anthoca01,PF,29,NYK,77,77,2982,743,1643,.452,167,415,.402,576,1228,.469,.503,459,541,.848,145,477,622,242,95,51,198,224,2112
19,Joel Anthony\anthojo01,C,31,TOT,33,0,186,12,32,.375,0,0,,12,32,.375,.375,4,8,.500,15,23,38,2,3,12,3,17,28
19,Joel Anthony\anthojo01,C,31,MIA,12,0,37,2,6,.333,0,0,,2,6,.333,.333,2,2,1.000,2,5,7,0,0,4,1,4,6
19,Joel Anthony\anthojo01,C,31,BOS,21,0,149,10,26,.385,0,0,,10,26,.385,.385,2,6,.333,13,18,31,2,3,8,2,13,22
20,Pero Antic\anticpe01,C,31,ATL,50,26,925,123,294,.418,56,171,.327,67,123,.545,.514,50,66,.758,57,152,209,58,19,12,55,126,352
21,Trevor Ariza\arizatr01,SF,28,WAS,77,77,2723,389,853,.456,180,442,.407,209,411,.509,.562,149,193,.772,99,376,475,191,126,20,132,179,1107
22,Hilton Armstrong\armsthi01,C,29,GSW,15,1,97,9,19,.474,0,0,,9,19,.474,.474,7,16,.438,19,28,47,5,4,4,6,11,25
23,Darrell Arthur\arthuda01,SF,25,DEN,68,1,1161,162,410,.395,24,64,.375,138,346,.399,.424,53,62,.855,52,158,210,61,39,47,58,185,401
24,Omer Asik\asikom01,C,27,HOU,48,19,968,101,190,.532,0,0,,101,190,.532,.532,78,126,.619,101,277,378,25,14,37,59,92,280
25,D.J. Augustin\augusdj01,PG,26,TOT,71,9,1939,298,718,.415,133,332,.401,165,386,.427,.508,201,227,.885,15,115,130,313,53,3,125,147,930
25,D.J. Augustin\augusdj01,PG,26,TOR,10,0,82,7,24,.292,1,11,.091,6,13,.462,.313,6,6,1.000,0,4,4,10,1,0,9,7,21
25,D.J. Augustin\augusdj01,PG,26,CHI,61,9,1857,291,694,.419,132,321,.411,159,373,.426,.514,195,221,.882,15,111,126,303,52,3,116,140,909
26,Gustavo Ayon\ayongu01,C,28,ATL,26,14,429,52,102,.510,0,0,,52,102,.510,.510,8,20,.400,42,83,125,28,25,10,29,47,112
27,Jeff Ayres\pendeje02,PF,26,SAS,73,10,952,101,174,.580,0,0,,101,174,.580,.580,38,55,.691,89,169,258,60,13,25,63,146,240
28,Chris Babb\babbch01,SG,23,BOS,14,0,132,8,30,.267,6,27,.222,2,3,.667,.367,0,0,,4,13,17,3,6,0,3,13,22
29,Luke Babbitt\babbilu01,PF,24,NOP,27,2,473,60,154,.390,36,95,.379,24,59,.407,.506,14,18,.778,18,70,88,29,7,11,15,52,170
30,Leandro Barbosa\barbole01,PG,31,PHO,20,0,368,56,131,.427,7,25,.280,49,106,.462,.454,31,39,.795,5,32,37,32,7,4,19,30,150
31,J.J. Barea\bareajo01,PG,29,MIN,79,1,1471,254,656,.387,73,231,.316,181,425,.426,.443,79,100,.790,16,138,154,303,26,0,125,129,660
32,Andrea Bargnani\bargnan01,C,28,NYK,42,39,1257,222,502,.442,30,108,.278,192,394,.487,.472,84,102,.824,69,153,222,45,14,52,58,100,558
33,Harrison Barnes\barneha02,SF,21,GSW,78,24,2204,271,679,.399,66,190,.347,205,489,.419,.448,130,181,.718,66,245,311,116,65,20,84,158,738
34,Matt Barnes\barnema02,SF,33,LAC,63,40,1735,231,527,.438,97,283,.343,134,244,.549,.530,66,90,.733,60,232,292,125,56,28,85,185,625
35,Will Barton\bartowi01,SG,23,POR,41,0,387,65,156,.417,10,33,.303,55,123,.447,.449,26,32,.813,16,58,74,33,9,7,18,31,166
36,Brandon Bass\bassbr01,PF,28,BOS,82,73,2266,352,725,.486,2,6,.333,350,719,.487,.487,205,239,.858,161,309,470,87,36,71,102,190,911
37,Shane Battier\battish01,SF,35,MIA,73,56,1468,105,275,.382,73,210,.348,32,65,.492,.515,15,23,.652,34,104,138,63,50,39,21,124,298
38,Nicolas Batum\batumni01,SF,25,POR,82,82,2956,381,819,.465,145,402,.361,236,417,.566,.554,163,203,.803,116,495,611,420,75,57,208,156,1070
39,Jerryd Bayless\bayleje01,PG,25,TOT,72,19,1686,248,617,.402,76,212,.358,172,405,.425,.464,94,118,.797,22,123,145,194,60,9,82,161,666
39,Jerryd Bayless\bayleje01,PG,25,MEM,31,5,650,90,239,.377,25,83,.301,65,156,.417,.429,45,57,.789,8,51,59,66,20,5,22,72,250
39,Jerryd Bayless\bayleje01,PG,25,BOS,41,14,1036,158,378,.418,51,129,.395,107,249,.430,.485,49,61,.803,14,72,86,128,40,4,60,89,416
40,Aron Baynes\baynear01,C,27,SAS,53,4,491,71,163,.436,0,0,,71,163,.436,.436,19,21,.905,57,88,145,34,2,5,36,77,161
41,Kent Bazemore\bazemke01,SG,24,TOT,67,15,911,147,343,.429,43,128,.336,104,215,.484,.491,66,109,.606,10,107,117,91,43,13,79,102,403
41,Kent Bazemore\bazemke01,SG,24,GSW,44,0,268,36,97,.371,10,39,.256,26,58,.448,.423,19,36,.528,5,35,40,20,12,6,28,42,101
41,Kent Bazemore\bazemke01,SG,24,LAL,23,15,643,111,246,.451,33,89,.371,78,157,.497,.518,47,73,.644,5,72,77,71,31,7,51,60,302
42,Bradley Beal\bealbr01,SG,20,WAS,73,73,2530,481,1149,.419,138,343,.402,343,806,.426,.479,149,189,.788,54,219,273,243,71,18,128,153,1249
43,Michael Beasley\beaslmi01,SF,25,MIA,55,2,831,177,355,.499,21,54,.389,156,301,.518,.528,61,79,.772,31,141,172,42,23,21,57,93,436
44,Marco Belinelli\belinma01,SF,27,SAS,80,25,2016,337,695,.485,126,293,.430,211,402,.525,.576,111,131,.847,18,208,226,179,50,7,95,130,911
45,Anthony Bennett\bennean01,PF,20,CLE,52,0,663,80,225,.356,13,53,.245,67,172,.390,.384,44,69,.638,49,106,155,17,21,8,47,93,217
46,Patrick Beverley\beverpa01,PG,25,HOU,56,55,1751,199,481,.414,92,255,.361,107,226,.473,.509,83,102,.814,72,124,196,151,77,23,66,174,573
47,Andris Biedrins\biedran01,C,27,UTA,6,0,45,1,1,1.000,0,0,,1,1,1.000,1.000,1,6,.167,2,15,17,0,0,0,2,6,3
48,Chauncey Billups\billuch01,SG,37,DET,19,7,309,24,79,.304,14,48,.292,10,31,.323,.392,10,12,.833,4,24,28,42,8,1,25,25,72
49,Bismack Biyombo\biyombi01,C,21,CHA,77,9,1072,88,144,.611,0,0,,88,144,.611,.611,46,89,.517,105,261,366,8,7,86,40,124,222
50,DeJuan Blair\blairde01,PF,24,DAL,78,13,1214,210,393,.534,0,2,.000,210,391,.537,.534,77,121,.636,139,229,368,70,60,21,77,192,497
51,Steve Blake\blakest01,PG,33,TOT,55,28,1498,133,353,.377,79,210,.376,54,143,.378,.489,33,43,.767,13,146,159,307,54,8,102,85,378
51,Steve Blake\blakest01,PG,33,LAL,27,27,891,88,233,.378,52,131,.397,36,102,.353,.489,28,35,.800,8,95,103,205,34,2,71,49,256
51,Steve Blake\blakest01,PG,33,GSW,28,1,607,45,120,.375,27,79,.342,18,41,.439,.488,5,8,.625,5,51,56,102,20,6,31,36,122
52,Andray Blatche\blatcan01,PF,27,BRK,73,7,1618,321,674,.476,15,54,.278,306,620,.494,.487,164,221,.742,120,270,390,112,75,38,110,166,821
53,Eric Bledsoe\bledser01,PG,24,PHO,43,40,1416,265,556,.477,50,140,.357,215,416,.517,.522,183,237,.772,27,175,202,235,69,14,143,99,763
54,Vander Blue\blueva01,SG,21,BOS,3,0,15,2,4,.500,0,1,.000,2,3,.667,.500,1,5,.200,0,3,3,1,0,0,2,1,5
55,Keith Bogans\boganke01,SG,33,BOS,6,0,55,3,6,.500,3,6,.500,0,0,,.750,3,3,1.000,0,3,3,3,1,0,1,2,12
56,Andrew Bogut\bogutan01,C,29,GSW,67,67,1769,235,375,.627,0,0,,235,375,.627,.627,22,64,.344,182,489,671,112,47,121,97,210,492
57,Matt Bonner\bonnema01,PF,33,SAS,61,0,690,73,164,.445,42,98,.429,31,66,.470,.573,9,12,.750,16,114,130,31,15,11,16,49,197
58,Trevor Booker\booketr01,PF,26,WAS,72,45,1553,222,403,.551,0,2,.000,222,401,.554,.551,47,76,.618,149,230,379,64,41,45,58,131,491
59,Carlos Boozer\boozeca01,PF,32,CHI,76,76,2141,447,980,.456,0,2,.000,447,978,.457,.456,148,193,.767,137,495,632,118,53,22,154,216,1042
60,Chris Bosh\boshch01,C,29,MIA,79,79,2531,492,953,.516,74,218,.339,418,735,.569,.555,223,272,.820,98,424,522,87,80,78,125,192,1281
61,Avery Bradley\bradlav01,SG,23,BOS,60,58,1855,361,825,.438,79,200,.395,282,625,.451,.485,90,112,.804,48,178,226,85,63,11,96,145,891
62,Elton Brand\brandel01,C,34,ATL,73,15,1414,179,332,.539,0,2,.000,179,330,.542,.539,61,94,.649,97,264,361,74,40,88,60,192,419
63,Corey Brewer\breweco01,SF,27,MIN,81,81,2609,388,807,.481,59,211,.280,329,596,.552,.517,163,227,.718,63,144,207,135,151,30,105,210,998
64,Ronnie Brewer\brewero02,SF,28,TOT,24,3,160,3,15,.200,1,8,.125,2,7,.286,.233,0,2,.000,2,12,14,10,6,1,2,4,7
64,Ronnie Brewer\brewero02,SF,28,HOU,23,3,158,3,15,.200,1,8,.125,2,7,.286,.233,0,2,.000,2,12,14,10,6,1,2,4,7
64,Ronnie Brewer\brewero02,SF,28,CHI,1,0,2,0,0,,0,0,,0,0,,,0,0,,0,0,0,0,0,0,0,0,0
65,Aaron Brooks\brookaa01,PG,29,TOT,72,12,1557,233,581,.401,96,248,.387,137,333,.411,.484,83,95,.874,43,97,140,233,52,13,117,146,645
65,Aaron Brooks\brookaa01,PG,29,HOU,43,0,716,104,263,.395,54,132,.409,50,131,.382,.498,37,44,.841,23,39,62,83,25,6,51,76,299
65,Aaron Brooks\brookaa01,PG,29,DEN,29,12,841,129,318,.406,42,116,.362,87,202,.431,.472,46,51,.902,20,58,78,150,27,7,66,70,346
66,MarShon Brooks\brookma01,SG,25,TOT,35,0,316,57,125,.456,13,25,.520,44,100,.440,.508,32,44,.727,10,44,54,25,14,4,24,21,159
66,MarShon Brooks\brookma01,SG,25,BOS,10,0,73,9,24,.375,2,4,.500,7,20,.350,.417,11,14,.786,1,18,19,4,1,1,7,5,31
66,MarShon Brooks\brookma01,SG,25,GSW,7,0,15,5,13,.385,0,2,.000,5,11,.455,.385,3,4,.750,1,4,5,0,1,0,0,0,13
66,MarShon Brooks\brookma01,SG,25,LAL,18,0,228,43,88,.489,11,19,.579,32,69,.464,.551,18,26,.692,8,22,30,21,12,3,17,16,115
67,Lorenzo Brown\brownlo01,PG,23,PHI,26,0,224,26,86,.302,3,30,.100,23,56,.411,.320,9,13,.692,8,20,28,41,13,3,16,19,64
68,Shannon Brown\brownsh01,SG,28,TOT,29,1,251,24,66,.364,0,2,.000,24,64,.375,.364,15,21,.714,7,21,28,9,13,0,18,24,63
68,Shannon Brown\brownsh01,SG,28,SAS,10,1,103,8,28,.286,0,2,.000,8,26,.308,.286,7,9,.778,1,12,13,5,1,0,8,12,23
68,Shannon Brown\brownsh01,SG,28,NYK,19,0,148,16,38,.421,0,0,,16,38,.421,.421,8,12,.667,6,9,15,4,12,0,10,12,40
69,Kobe Bryant\bryanko01,SG,35,LAL,6,6,177,31,73,.425,3,16,.188,28,57,.491,.445,18,21,.857,2,24,26,38,7,1,34,9,83
70,Chase Budinger\budinch01,SF,25,MIN,41,8,751,100,254,.394,42,120,.350,58,134,.433,.476,32,39,.821,19,84,103,31,19,2,24,58,274
71,Reggie Bullock\bullore01,SF,22,LAC,43,0,395,43,121,.355,22,73,.301,21,48,.438,.446,7,9,.778,11,43,54,12,9,1,13,26,115
72,Trey Burke\burketr01,PG,21,UTA,70,68,2262,341,897,.380,111,336,.330,230,561,.410,.442,102,113,.903,37,171,208,396,42,6,131,145,895
73,Alec Burks\burksal01,SG,22,UTA,78,12,2193,380,831,.457,50,143,.350,330,688,.480,.487,279,373,.748,59,198,257,212,69,14,149,190,1089
74,Caron Butler\butleca01,SF,33,TOT,56,13,1419,213,540,.394,98,249,.394,115,291,.395,.485,63,75,.840,21,208,229,82,47,17,60,120,587
74,Caron Butler\butleca01,SF,33,MIL,34,13,821,137,354,.387,53,147,.361,84,207,.406,.462,47,56,.839,16,142,158,56,23,11,52,64,374
74,Caron Butler\butleca01,SF,33,OKC,22,0,598,76,186,.409,45,102,.441,31,84,.369,.530,16,19,.842,5,66,71,26,24,6,8,56,213
75,Jimmy Butler\butleji01,SG,24,CHI,67,67,2591,275,693,.397,68,240,.283,207,453,.457,.446,260,338,.769,87,243,330,175,127,36,102,106,878
76,Rasual Butler\butlera01,SG,34,IND,50,2,378,51,110,.464,26,62,.419,25,48,.521,.582,8,14,.571,6,35,41,17,7,9,11,30,136
77,Dwight Buycks\buyckdw01,PG,24,TOR,14,0,146,15,48,.313,5,17,.294,10,31,.323,.365,8,9,.889,4,19,23,10,8,0,10,11,43
78,Andrew Bynum\bynuman01,C,26,TOT,26,19,516,94,225,.418,0,0,,94,225,.418,.418,37,49,.755,53,92,145,29,6,29,34,31,225
78,Andrew Bynum\bynuman01,C,26,CLE,24,19,480,85,203,.419,0,0,,85,203,.419,.419,32,42,.762,47,79,126,27,6,28,30,28,202
78,Andrew Bynum\bynuman01,C,26,IND,2,0,36,9,22,.409,0,0,,9,22,.409,.409,5,7,.714,6,13,19,2,0,1,4,3,23
79,Will Bynum\bynumwi01,PG,31,DET,56,3,1054,184,430,.428,20,62,.323,164,368,.446,.451,97,121,.802,24,75,99,216,39,7,103,121,485
80,Nick Calathes\calatni01,SG,24,MEM,71,7,1173,142,311,.457,19,61,.311,123,250,.492,.487,44,72,.611,23,114,137,207,66,8,101,117,347
81,Jose Calderon\caldejo01,PG,32,DAL,81,81,2468,341,748,.456,191,425,.449,150,323,.464,.584,52,63,.825,29,163,192,377,69,11,103,136,925
82,Kentavious Caldwell-Pope\caldwke01,SG,20,DET,80,41,1583,182,460,.396,59,185,.319,123,275,.447,.460,47,61,.770,38,118,156,55,75,12,28,145,470
83,Isaiah Canaan\canaais01,PG,22,HOU,22,0,252,31,87,.356,18,55,.327,13,32,.406,.460,21,29,.724,7,17,24,22,8,4,21,25,101
84,DeMarre Carroll\carrode01,SF,27,ATL,73,73,2341,302,642,.470,97,268,.362,205,374,.548,.546,109,141,.773,107,296,403,134,108,21,79,188,810
85,Vince Carter\cartevi01,SG,37,DAL,81,0,1973,330,811,.407,146,371,.394,184,440,.418,.497,161,196,.821,67,217,284,212,61,35,108,209,967
86,Michael Carter-Williams\cartemi01,PG,22,PHI,70,70,2414,427,1054,.405,55,208,.264,372,846,.440,.431,258,367,.703,101,336,437,441,130,43,247,213,1167
87,Omri Casspi\casspom01,PF,25,HOU,71,2,1283,173,410,.422,61,176,.347,112,234,.479,.496,83,122,.680,55,205,260,88,44,14,72,100,490
88,Mario Chalmers\chalmma01,PG,27,MIA,73,73,2178,254,560,.454,87,226,.385,167,334,.500,.531,121,163,.742,41,173,214,357,119,16,162,210,716
89,Tyson Chandler\chandty01,C,31,NYK,55,55,1662,191,322,.593,0,1,.000,191,321,.595,.593,98,155,.632,159,370,529,59,36,63,71,145,480
90,Wilson Chandler\chandwi01,SF,26,DEN,62,55,1927,307,738,.416,122,351,.348,185,387,.478,.499,110,152,.724,58,236,294,114,46,31,79,193,846
91,Josh Childress\childjo01,SF,30,NOP,4,0,24,0,0,,0,0,,0,0,,,0,0,,0,3,3,2,1,0,1,1,0
92,Dionte Christmas\chrisdi01,SF,27,PHO,31,0,198,22,62,.355,9,31,.290,13,31,.419,.427,18,24,.750,13,25,38,8,2,3,6,19,71
93,Earl Clark\clarkea01,PF,26,TOT,54,17,768,97,261,.372,41,122,.336,56,139,.403,.450,22,34,.647,22,121,143,18,17,25,31,67,257
93,Earl Clark\clarkea01,PF,26,CLE,45,17,698,90,240,.375,40,116,.345,50,124,.403,.458,14,24,.583,20,107,127,16,16,19,30,61,234
93,Earl Clark\clarkea01,PF,26,NYK,9,0,70,7,21,.333,1,6,.167,6,15,.400,.357,8,10,.800,2,14,16,2,1,6,1,6,23
94,Ian Clark\clarkia01,SG,22,UTA,23,0,172,26,67,.388,11,31,.355,15,36,.417,.470,5,7,.714,3,16,19,15,8,2,14,24,68
95,Victor Claver\clavevi01,SF,25,POR,21,0,184,17,42,.405,3,18,.167,14,24,.583,.440,10,11,.909,9,30,39,12,3,3,11,16,47
96,Norris Cole\coleno01,PG,25,MIA,82,6,2014,207,500,.414,60,174,.345,147,326,.451,.474,53,68,.779,17,143,160,248,77,5,127,156,527
97,Jason Collins\collija04,C,35,BRK,22,1,172,11,24,.458,0,3,.000,11,21,.524,.458,3,4,.750,7,12,19,4,8,1,7,30,25
98,Darren Collison\collida01,PG,26,LAC,80,35,2069,324,694,.467,71,189,.376,253,505,.501,.518,192,224,.857,47,141,188,297,93,15,132,150,911
99,Nick Collison\collini01,PF,33,OKC,81,0,1353,134,241,.556,4,17,.235,130,224,.580,.564,66,93,.710,116,177,293,104,30,28,71,187,338
100,Mike Conley\conlemi01,PG,26,MEM,73,73,2446,463,1030,.450,105,291,.361,358,739,.484,.500,225,276,.815,41,172,213,441,110,13,150,141,1256
101,Chris Copeland\copelch01,SF,29,IND,41,0,265,55,117,.470,33,79,.418,22,38,.579,.611,10,14,.714,7,25,32,18,3,7,14,38,153
102,DeMarcus Cousins\couside01,C,23,SAC,71,71,2298,591,1191,.496,0,7,.000,591,1184,.499,.496,432,595,.726,218,613,831,207,109,91,251,270,1614
103,Robert Covington\covinro01,SF,23,HOU,7,0,34,6,14,.429,4,11,.364,2,3,.667,.571,0,0,,2,3,5,0,2,0,1,3,16
104,Allen Crabbe\crabbal01,SG,21,POR,15,0,100,12,33,.364,6,14,.429,6,19,.316,.455,3,4,.750,1,8,9,6,2,1,3,10,33
105,Jamal Crawford\crawfja01,SG,33,LAC,69,24,2094,421,1011,.416,161,446,.361,260,565,.460,.496,279,322,.866,34,124,158,223,59,12,135,120,1282
106,Jordan Crawford\crawfjo02,SG-PG,25,TOT,81,35,1859,327,788,.415,90,285,.316,237,503,.471,.472,146,169,.864,28,155,183,281,47,5,134,120,890
106,Jordan Crawford\crawfjo02,PG,25,BOS,39,35,1198,188,455,.413,50,157,.318,138,298,.463,.468,110,126,.873,18,102,120,224,34,3,84,76,536
106,Jordan Crawford\crawfjo02,SG,25,GSW,42,0,661,139,333,.417,40,128,.313,99,205,.483,.477,36,43,.837,10,53,63,57,13,2,50,44,354
107,Jae Crowder\crowdja01,SF,23,DAL,78,8,1254,130,296,.439,50,151,.331,80,145,.552,.524,46,61,.754,46,148,194,60,59,21,41,100,356
108,Dante Cunningham\cunnida01,PF,26,MIN,81,7,1635,236,509,.464,0,5,.000,236,504,.468,.464,38,67,.567,112,218,330,83,62,58,42,146,510
109,Jared Cunningham\cunnija01,SG,22,TOT,13,0,80,6,21,.286,1,7,.143,5,14,.357,.310,13,16,.813,1,5,6,8,3,0,2,16,26
109,Jared Cunningham\cunnija01,SG,22,ATL,5,0,22,1,2,.500,0,1,.000,1,1,1.000,.500,0,2,.000,0,1,1,3,0,0,2,3,2
109,Jared Cunningham\cunnija01,SG,22,SAC,8,0,58,5,19,.263,1,6,.167,4,13,.308,.289,13,14,.929,1,4,5,5,3,0,0,13,24
110,Seth Curry\curryse01,PG,23,TOT,2,0,13,1,3,.333,1,1,1.000,0,2,.000,.500,0,0,,0,1,1,0,2,0,0,0,3
110,Seth Curry\curryse01,PG,23,MEM,1,0,4,0,0,,0,0,,0,0,,,0,0,,0,0,0,0,0,0,0,0,0
110,Seth Curry\curryse01,PG,23,CLE,1,0,9,1,3,.333,1,1,1.000,0,2,.000,.500,0,0,,0,1,1,0,2,0,0,0,3
111,Stephen Curry\curryst01,PG,25,GSW,78,78,2846,652,1383,.471,261,615,.424,391,768,.509,.566,308,348,.885,46,288,334,666,128,14,294,194,1873
112,Samuel Dalembert\dalemsa01,C,32,DAL,80,68,1614,214,377,.568,0,1,.000,214,376,.569,.568,101,137,.737,200,341,541,38,41,94,90,210,529
113,Troy Daniels\danietr01,SG,22,HOU,5,1,75,15,31,.484,12,25,.480,3,6,.500,.677,0,0,,0,4,4,5,0,0,3,6,42
114,Luigi Datome\datomlu01,SF,26,DET,34,0,238,34,97,.351,7,39,.179,27,58,.466,.387,8,10,.800,14,32,46,11,6,1,11,20,83
115,Brandon Davies\daviebr01,PF,22,PHI,51,0,575,54,128,.422,2,10,.200,52,118,.441,.430,34,53,.642,38,71,109,28,24,8,35,92,144
116,Anthony Davis\davisan02,PF,20,NOP,67,66,2358,522,1005,.519,2,9,.222,520,996,.522,.520,348,440,.791,207,466,673,105,89,189,109,200,1394
117,Ed Davis\davised01,PF,24,MEM,63,4,956,155,290,.534,0,0,,155,290,.534,.534,47,89,.528,92,168,260,27,17,43,40,114,357
118,Glen Davis\davisgl01,PF,28,TOT,68,44,1662,271,593,.457,4,11,.364,267,582,.459,.460,95,137,.693,108,243,351,77,58,29,76,159,641
118,Glen Davis\davisgl01,PF,28,ORL,45,43,1354,232,512,.453,4,10,.400,228,502,.454,.457,77,114,.675,87,195,282,70,46,22,59,111,545
118,Glen Davis\davisgl01,PF,28,LAC,23,1,308,39,81,.481,0,1,.000,39,80,.488,.481,18,23,.783,21,48,69,7,12,7,17,48,96
119,Austin Daye\dayeau01,SF,25,TOT,22,1,148,24,68,.353,12,37,.324,12,31,.387,.441,6,10,.600,5,22,27,8,4,4,5,18,66
119,Austin Daye\dayeau01,SF,25,TOR,8,0,33,3,13,.231,0,8,.000,3,5,.600,.231,2,3,.667,2,5,7,2,0,0,0,4,8
119,Austin Daye\dayeau01,SF,25,SAS,14,1,115,21,55,.382,12,29,.414,9,26,.346,.491,4,7,.571,3,17,20,6,4,4,5,14,58
120,Nando De Colo\decolna01,SF,26,TOT,47,3,494,64,153,.418,18,53,.340,46,100,.460,.477,31,35,.886,14,59,73,65,22,6,35,48,177
120,Nando De Colo\decolna01,SF,26,SAS,26,3,301,42,93,.452,10,31,.323,32,62,.516,.505,18,22,.818,6,39,45,32,15,3,21,25,112
120,Nando De Colo\decolna01,SF,26,TOR,21,0,193,22,60,.367,8,22,.364,14,38,.368,.433,13,13,1.000,8,20,28,33,7,3,14,23,65
121,Dewayne Dedmon\dedmode01,C,24,TOT,31,6,390,38,83,.458,0,0,,38,83,.458,.458,21,32,.656,38,89,127,5,7,22,18,66,97
121,Dewayne Dedmon\dedmode01,C,24,GSW,4,0,6,0,1,.000,0,0,,0,1,.000,.000,1,2,.500,0,0,0,0,0,0,0,1,1
121,Dewayne Dedmon\dedmode01,C,24,PHI,11,0,150,15,29,.517,0,0,,15,29,.517,.517,7,13,.538,11,38,49,3,0,9,9,28,37
121,Dewayne Dedmon\dedmode01,C,24,ORL,16,6,234,23,53,.434,0,0,,23,53,.434,.434,13,17,.765,27,51,78,2,7,13,9,37,59
122,Matthew Dellavedova\dellama01,SG,23,CLE,72,4,1271,122,296,.412,57,155,.368,65,141,.461,.508,38,48,.792,29,94,123,187,33,5,60,121,339
123,Luol Deng\denglu01,SF,28,TOT,63,63,2213,371,860,.431,57,189,.302,314,671,.468,.465,212,268,.791,99,262,361,183,62,9,114,111,1011
123,Luol Deng\denglu01,SF,28,CHI,23,23,860,160,354,.452,17,62,.274,143,292,.490,.476,101,124,.815,40,118,158,85,24,4,59,53,438
123,Luol Deng\denglu01,SF,28,CLE,40,40,1353,211,506,.417,40,127,.315,171,379,.451,.457,111,144,.771,59,144,203,98,38,5,55,58,573
124,DeMar DeRozan\derozde01,SG,24,TOR,79,79,3017,604,1407,.429,64,210,.305,540,1197,.451,.452,519,630,.824,51,292,343,313,86,28,176,197,1791
125,Boris Diaw\diawbo01,PF,31,SAS,79,24,1974,302,580,.521,45,112,.402,257,468,.549,.559,68,92,.739,74,252,326,222,44,32,121,140,717
126,Gorgui Dieng\dienggo01,C,24,MIN,60,15,818,113,227,.498,1,1,1.000,112,226,.496,.500,59,93,.634,103,197,300,39,30,50,54,108,286
127,Toney Douglas\douglto01,PG,27,TOT,51,17,675,73,190,.384,31,102,.304,42,88,.477,.466,25,34,.735,18,69,87,68,19,5,34,81,202
127,Toney Douglas\douglto01,PG,27,GSW,24,0,265,32,86,.372,19,59,.322,13,27,.481,.483,5,8,.625,4,22,26,19,6,2,16,34,88
127,Toney Douglas\douglto01,PG,27,MIA,27,17,410,41,104,.394,12,43,.279,29,61,.475,.452,20,26,.769,14,47,61,49,13,3,18,47,114
128,Chris Douglas-Roberts\douglch01,SF,27,CHA,49,8,1016,111,252,.440,51,132,.386,60,120,.500,.542,66,82,.805,16,103,119,51,29,16,36,61,339
129,Goran Dragic\dragigo01,SG,27,PHO,76,75,2668,552,1093,.505,122,299,.408,430,794,.542,.561,316,416,.760,69,176,245,447,104,22,213,206,1542
130,Andre Drummond\drumman01,C,20,DET,81,81,2619,479,769,.623,0,2,.000,479,767,.625,.623,137,328,.418,440,631,1071,35,101,131,110,273,1095
131,Jared Dudley\dudleja01,SF,28,LAC,74,43,1729,196,447,.438,81,225,.360,115,222,.518,.529,38,58,.655,36,124,160,104,41,10,56,146,511
132,Tim Duncan\duncati01,C,37,SAS,74,74,2158,444,906,.490,0,5,.000,444,901,.493,.490,231,316,.731,158,563,721,220,43,139,159,134,1119
133,Mike Dunleavy\dunlemi02,SF,33,CHI,82,61,2584,333,774,.430,123,324,.380,210,450,.467,.510,140,164,.854,46,299,345,186,64,46,108,163,929
134,Kevin Durant\duranke01,SF,25,OKC,81,81,3122,849,1688,.503,192,491,.391,657,1197,.549,.560,703,805,.873,58,540,598,445,103,59,285,174,2593
135,Shane Edwards\edwarsh01,SF,26,CLE,2,0,12,1,3,.333,0,0,,1,3,.333,.333,0,0,,1,1,2,0,0,0,1,1,2
136,Wayne Ellington\ellinwa01,SG,26,DAL,45,1,393,55,126,.437,25,59,.424,30,67,.448,.536,10,11,.909,8,35,43,19,16,2,11,33,145
137,Monta Ellis\ellismo01,SG,28,DAL,82,82,3023,576,1278,.451,69,209,.330,507,1069,.474,.478,339,430,.788,38,257,295,471,141,23,264,197,1560
138,Melvin Ely\elyme01,C,35,NOP,2,0,27,3,6,.500,0,0,,3,6,.500,.500,0,0,,0,1,1,0,0,1,0,5,6
139,Jeremy Evans\evansje01,SF,26,UTA,66,4,1209,175,332,.527,0,2,.000,175,330,.530,.527,51,75,.680,120,190,310,44,42,46,40,139,401
140,Reggie Evans\evansre01,PF,33,TOT,54,20,899,71,150,.473,0,0,,71,150,.473,.473,72,130,.554,115,219,334,21,37,3,58,119,214
140,Reggie Evans\evansre01,PF,33,BRK,30,6,399,23,59,.390,0,0,,23,59,.390,.390,35,65,.538,53,96,149,5,13,2,28,54,81
140,Reggie Evans\evansre01,PF,33,SAC,24,14,500,48,91,.527,0,0,,48,91,.527,.527,37,65,.569,62,123,185,16,24,1,30,65,133
141,Tyreke Evans\evansty01,SF,24,NOP,72,22,2028,391,897,.436,21,95,.221,370,802,.461,.448,239,310,.771,76,265,341,363,84,21,175,155,1042
142,Kenneth Faried\farieke01,PF,24,DEN,80,77,2178,447,820,.545,0,3,.000,447,817,.547,.545,202,311,.650,238,446,684,96,70,69,135,193,1096
143,Jordan Farmar\farmajo01,PG,27,LAL,41,5,912,151,364,.415,70,160,.438,81,204,.397,.511,44,59,.746,20,84,104,199,38,8,95,65,416
144,Vitor Faverani\favervi01,C,25,BOS,37,8,488,64,147,.435,12,40,.300,52,107,.486,.476,24,37,.649,42,86,128,16,14,27,41,74,164
145,Derrick Favors\favorde01,PF,22,UTA,73,73,2201,390,747,.522,0,1,.000,390,746,.523,.522,190,284,.669,199,438,637,91,75,108,129,236,970
146,Carrick Felix\felixca01,SG,23,CLE,7,0,38,7,14,.500,2,5,.400,5,9,.556,.571,3,4,.750,1,5,6,4,0,0,4,4,19
147,Raymond Felton\feltora01,PG,29,NYK,65,65,2017,240,608,.395,62,195,.318,178,413,.431,.446,88,122,.721,54,143,197,365,78,27,129,157,630
148,Landry Fields\fieldla01,SF,25,TOR,30,2,322,27,67,.403,0,5,.000,27,62,.435,.403,14,22,.636,15,44,59,20,10,3,11,25,68
149,Derek Fisher\fishede01,SG,39,OKC,81,0,1428,141,361,.391,88,229,.384,53,132,.402,.512,55,71,.775,12,110,122,117,70,3,49,157,425
150,Evan Fournier\fournev01,SG,21,DEN,76,4,1503,228,544,.419,89,237,.376,139,307,.453,.501,93,123,.756,34,168,202,112,34,7,100,179,638
151,Randy Foye\foyera01,SG,30,DEN,81,78,2485,361,875,.413,189,498,.380,172,377,.456,.521,157,185,.849,36,196,232,287,67,39,145,205,1068
152,Jamaal Franklin\frankja01,SG,22,MEM,21,0,161,16,39,.410,5,11,.455,11,28,.393,.474,2,2,1.000,4,19,23,6,4,2,11,23,39
153,Jimmer Fredette\fredeji01,SG,24,TOT,49,0,519,107,227,.471,40,84,.476,67,143,.469,.559,19,21,.905,8,44,52,64,14,3,48,35,273
153,Jimmer Fredette\fredeji01,SG,24,SAC,41,0,463,94,198,.475,36,73,.493,58,125,.464,.566,17,19,.895,7,38,45,61,14,3,44,28,241
153,Jimmer Fredette\fredeji01,SG,24,CHI,8,0,56,13,29,.448,4,11,.364,9,18,.500,.517,2,2,1.000,1,6,7,3,0,0,4,7,32
154,Joel Freeland\freeljo01,C,26,POR,52,0,727,77,162,.475,0,2,.000,77,160,.481,.475,20,29,.690,88,120,208,36,10,22,32,95,174
155,Channing Frye\fryech01,PF,30,PHO,82,82,2312,336,778,.432,160,432,.370,176,346,.509,.535,78,95,.821,73,343,416,98,60,63,89,245,910
156,Francisco Garcia\garcifr01,SF,32,HOU,55,4,1083,118,294,.401,69,193,.358,49,101,.485,.519,10,19,.526,21,101,122,63,27,33,30,120,315
157,Kevin Garnett\garneke01,C,37,BRK,54,54,1109,157,356,.441,0,3,.000,157,353,.445,.441,38,47,.809,60,298,358,82,43,40,69,123,352
158,Diante Garrett\garredi02,PG,25,UTA,71,0,1048,101,265,.381,36,96,.375,65,169,.385,.449,10,12,.833,11,86,97,120,41,5,75,75,248
159,Marc Gasol\gasolma01,C,29,MEM,59,59,1970,336,711,.473,2,11,.182,334,700,.477,.474,185,241,.768,84,340,424,215,59,76,111,150,859
160,Pau Gasol\gasolpa01,C,33,LAL,60,60,1884,425,885,.480,4,14,.286,421,871,.483,.482,187,254,.736,124,456,580,201,27,92,141,124,1041
161,Rudy Gay\gayru01,SF,27,TOT,73,73,2531,537,1179,.455,65,197,.330,472,982,.481,.483,318,387,.822,113,324,437,209,95,56,224,171,1457
161,Rudy Gay\gayru01,SF,27,TOR,18,18,639,130,335,.388,22,59,.373,108,276,.391,.421,68,88,.773,29,104,133,40,28,23,59,47,350
161,Rudy Gay\gayru01,SF,27,SAC,55,55,1892,407,844,.482,43,138,.312,364,706,.516,.508,250,299,.836,84,220,304,169,67,33,165,124,1107
162,Alonzo Gee\geeal01,SF,26,CLE,65,24,1020,98,236,.415,19,58,.328,79,178,.444,.456,43,61,.705,35,114,149,47,39,15,44,96,258
163,Paul George\georgpa01,SF,23,IND,80,80,2898,577,1362,.424,182,500,.364,395,862,.458,.490,401,464,.864,64,478,542,283,151,22,224,198,1737
164,Taj Gibson\gibsota01,PF,28,CHI,82,8,2351,429,896,.479,0,7,.000,429,889,.483,.479,211,281,.751,200,358,558,91,41,112,150,207,1069
165,Manu Ginobili\ginobma01,SG,36,SAS,68,3,1550,294,627,.469,90,258,.349,204,369,.553,.541,160,188,.851,30,172,202,293,70,17,139,128,838
166,Rudy Gobert\goberru01,C,21,UTA,45,0,434,36,74,.486,0,0,,36,74,.486,.486,32,65,.492,51,104,155,7,8,41,32,57,104
167,Ryan Gomes\gomesry01,SF,31,OKC,5,0,34,3,8,.375,0,2,.000,3,6,.500,.375,0,0,,0,4,4,1,0,0,1,5,6
168,Drew Gooden\goodedr01,C,32,WAS,22,0,395,76,143,.531,7,17,.412,69,126,.548,.556,24,27,.889,37,77,114,15,10,7,17,53,183
169,Archie Goodwin\goodwar01,SG,19,PHO,52,0,533,76,167,.455,5,36,.139,71,131,.542,.470,37,55,.673,25,62,87,20,20,11,44,45,194
170,Ben Gordon\gordobe01,SG,30,CHA,19,0,279,37,108,.343,8,29,.276,29,79,.367,.380,17,21,.810,3,24,27,21,10,2,21,18,99
171,Eric Gordon\gordoer01,SG,25,NOP,64,64,2057,356,817,.436,101,258,.391,255,559,.456,.498,175,223,.785,30,135,165,208,74,12,134,114,988
172,Marcin Gortat\gortama01,C,29,WAS,81,80,2655,455,840,.542,1,1,1.000,454,839,.541,.542,157,229,.686,202,565,767,138,41,121,126,201,1068
173,Danny Granger\grangda01,SF,30,TOT,41,2,847,116,307,.378,43,128,.336,73,179,.408,.448,63,67,.940,31,102,133,41,12,17,46,62,338
173,Danny Granger\grangda01,SF,30,IND,29,2,653,80,223,.359,31,94,.330,49,129,.380,.428,51,53,.962,24,81,105,33,9,13,36,41,242
173,Danny Granger\grangda01,SF,30,LAC,12,0,194,36,84,.429,12,34,.353,24,50,.480,.500,12,14,.857,7,21,28,8,3,4,10,21,96
174,Aaron Gray\grayaa01,C,29,TOT,37,6,355,27,61,.443,0,1,.000,27,60,.450,.443,11,20,.550,42,69,111,22,10,8,31,64,65
174,Aaron Gray\grayaa01,C,29,TOR,4,0,20,2,3,.667,0,0,,2,3,.667,.667,1,2,.500,3,5,8,3,0,0,4,7,5
174,Aaron Gray\grayaa01,C,29,SAC,33,6,335,25,58,.431,0,1,.000,25,57,.439,.431,10,18,.556,39,64,103,19,10,8,27,57,60
175,Danny Green\greenda02,SG,26,SAS,68,59,1651,218,505,.432,132,318,.415,86,187,.460,.562,50,63,.794,25,204,229,104,65,61,76,107,618
176,Draymond Green\greendr01,SF,23,GSW,82,12,1797,187,459,.407,55,165,.333,132,294,.449,.467,82,123,.667,86,323,409,152,102,72,91,231,511
177,Gerald Green\greenge01,SG,28,PHO,82,48,2330,448,1006,.445,204,510,.400,244,496,.492,.547,195,230,.848,48,227,275,122,70,42,145,220,1295
178,Jeff Green\greenje02,SF,27,BOS,82,82,2805,482,1171,.412,135,396,.341,347,775,.448,.469,283,356,.795,54,326,380,138,57,47,165,180,1382
179,Willie Green\greenwi01,SG,32,LAC,55,9,869,102,271,.376,41,121,.339,61,150,.407,.452,28,34,.824,12,66,78,50,22,11,34,96,273
180,Blake Griffin\griffbl01,PF,24,LAC,80,80,2863,718,1359,.528,12,44,.273,706,1315,.537,.533,482,674,.715,192,565,757,309,92,51,224,265,1930
181,Jorge Gutierrez\gutiejo01,PG,25,BRK,15,2,244,25,54,.463,3,12,.250,22,42,.524,.491,9,12,.750,3,19,22,30,10,1,14,37,62
182,Jordan Hamilton\hamiljo02,SF,23,TOT,60,12,1019,147,376,.391,70,198,.354,77,178,.433,.484,40,51,.784,32,162,194,52,44,20,46,67,404
182,Jordan Hamilton\hamiljo02,SF,23,DEN,39,11,670,99,254,.390,45,129,.349,54,125,.432,.478,23,31,.742,23,110,133,34,31,13,27,31,266
182,Jordan Hamilton\hamiljo02,SF,23,HOU,21,1,349,48,122,.393,25,69,.362,23,53,.434,.496,17,20,.850,9,52,61,18,13,7,19,36,138
183,Justin Hamilton\hamilju01,C,23,TOT,8,0,72,9,20,.450,3,9,.333,6,11,.545,.525,5,5,1.000,4,3,7,0,5,0,4,8,26
183,Justin Hamilton\hamilju01,C,23,CHA,1,0,4,0,0,,0,0,,0,0,,,0,0,,0,0,0,0,1,0,1,0,0
183,Justin Hamilton\hamilju01,C,23,MIA,7,0,68,9,20,.450,3,9,.333,6,11,.545,.525,5,5,1.000,4,3,7,0,4,0,3,8,26
184,Tyler Hansbrough\hansbty01,PF,28,TOR,64,4,978,93,196,.474,0,2,.000,93,194,.479,.474,126,185,.681,120,167,287,17,28,19,47,132,312
185,Tim Hardaway\hardati02,SG,21,NYK,81,1,1875,294,687,.428,130,358,.363,164,329,.498,.523,106,128,.828,19,102,121,66,44,7,47,144,824
186,James Harden\hardeja01,SG,24,HOU,73,73,2777,549,1205,.456,177,483,.366,372,722,.515,.529,576,665,.866,61,283,344,446,115,29,265,177,1851
187,Maurice Harkless\harklma01,SF,20,ORL,80,41,1950,224,483,.464,59,154,.383,165,329,.502,.525,85,143,.594,69,195,264,80,97,50,86,140,592
188,Josh Harrellson\harrejo01,C,24,DET,32,0,317,38,82,.463,12,31,.387,26,51,.510,.537,5,7,.714,30,46,76,15,6,15,10,44,93
189,Al Harrington\harrial01,PF,33,WAS,34,0,511,82,207,.396,34,100,.340,48,107,.449,.478,27,35,.771,15,65,80,28,14,0,34,72,225
190,Devin Harris\harride01,PG,30,DAL,40,0,818,96,254,.378,31,101,.307,65,153,.425,.439,92,115,.800,8,77,85,178,28,2,59,72,315
191,Elias Harris\harriel01,SF,24,LAL,2,0,11,0,1,.000,0,0,,0,1,.000,.000,0,0,,1,0,1,1,1,0,0,0,0
192,Manny Harris\harrima01,SG,24,LAL,9,0,180,28,70,.400,7,20,.350,21,50,.420,.450,10,12,.833,7,27,34,11,4,1,9,10,73
193,Mike Harris\harrimi01,PF,30,UTA,20,0,225,29,61,.475,0,2,.000,29,59,.492,.475,26,27,.963,15,18,33,5,16,7,11,36,84
194,Tobias Harris\harrito02,PF,21,ORL,61,36,1850,332,716,.464,32,126,.254,300,590,.508,.486,197,244,.807,88,336,424,82,41,24,78,143,893
195,Udonis Haslem\hasleud01,PF,33,MIA,46,18,653,74,146,.507,0,0,,74,146,.507,.507,25,44,.568,42,133,175,13,11,15,24,79,173
196,Spencer Hawes\hawessp01,C,25,TOT,80,78,2470,403,883,.456,128,308,.416,275,575,.478,.529,119,152,.783,131,529,660,240,44,94,173,237,1053
196,Spencer Hawes\hawessp01,C,25,PHI,53,53,1666,264,586,.451,81,203,.399,183,383,.478,.520,79,101,.782,88,364,452,176,31,67,119,154,688
196,Spencer Hawes\hawessp01,C,25,CLE,27,25,804,139,297,.468,47,105,.448,92,192,.479,.547,40,51,.784,43,165,208,64,13,27,54,83,365
197,Chuck Hayes\hayesch01,C,30,TOT,61,1,754,56,130,.431,0,1,.000,56,129,.434,.431,20,25,.800,69,141,210,35,34,12,33,95,132
197,Chuck Hayes\hayesch01,C,30,SAC,16,1,179,14,32,.438,0,0,,14,32,.438,.438,5,7,.714,20,27,47,6,11,2,7,18,33
197,Chuck Hayes\hayesch01,C,30,TOR,45,0,575,42,98,.429,0,1,.000,42,97,.433,.429,15,18,.833,49,114,163,29,23,10,26,77,99
198,Gordon Hayward\haywago01,SF,23,UTA,77,77,2800,426,1032,.413,85,280,.304,341,752,.453,.454,311,381,.816,62,329,391,400,110,40,212,155,1248
199,Gerald Henderson\hendege02,SG,26,CHA,77,77,2461,403,930,.433,40,115,.348,363,815,.445,.455,235,309,.761,31,279,310,199,51,32,113,159,1081
200,Xavier Henry\henryxa01,SF,22,LAL,43,5,908,144,345,.417,28,81,.346,116,264,.439,.458,116,177,.655,25,89,114,51,44,7,57,79,432
201,John Henson\hensojo01,PF,23,MIL,70,23,1856,344,639,.538,0,1,.000,344,638,.539,.538,91,177,.514,171,326,497,113,41,116,114,185,779
202,Roy Hibbert\hibbero01,C,27,IND,81,81,2409,331,754,.439,2,5,.400,329,749,.439,.440,207,269,.770,202,336,538,91,29,182,148,269,871
203,J.J. Hickson\hicksjj01,PF,25,DEN,69,52,1859,332,654,.508,0,8,.000,332,646,.514,.508,150,290,.517,206,426,632,96,47,51,128,177,814
204,Nene Hilario\hilarne01,PF,31,WAS,53,37,1560,299,594,.503,1,5,.200,298,589,.506,.504,155,266,.583,65,229,294,153,64,47,117,164,754
205,George Hill\hillge01,PG,27,IND,76,76,2434,272,616,.442,95,260,.365,177,356,.497,.519,142,176,.807,53,230,283,265,75,23,92,158,781
206,Jordan Hill\hilljo01,PF,26,LAL,72,32,1500,286,521,.549,0,1,.000,286,520,.550,.549,124,181,.685,194,341,535,54,29,64,75,172,696
207,Solomon Hill\hillso01,SF,22,IND,28,0,226,17,40,.425,7,23,.304,10,17,.588,.513,6,7,.857,9,32,41,12,5,2,13,19,47
208,Kirk Hinrich\hinriki01,PG,33,CHI,73,61,2116,243,619,.393,85,242,.351,158,377,.419,.461,95,125,.760,31,161,192,286,80,26,120,203,666
209,Jrue Holiday\holidjr01,PG,23,NOP,34,34,1143,203,454,.447,30,77,.390,173,377,.459,.480,51,63,.810,28,114,142,268,56,12,105,92,487
210,Ryan Hollins\holliry01,PF,29,LAC,61,0,482,53,72,.736,0,0,,53,72,.736,.736,35,56,.625,31,59,90,8,9,31,29,87,141
211,Scotty Hopson\hopsosc01,SG,24,CLE,2,0,7,0,4,.000,0,2,.000,0,2,.000,.000,1,2,.500,0,0,0,1,1,0,0,0,1
212,Al Horford\horfoal01,C,27,ATL,29,29,958,238,420,.567,4,11,.364,234,409,.572,.571,58,85,.682,66,178,244,76,27,44,64,56,538
213,Dwight Howard\howardw01,C,28,HOU,71,71,2396,473,800,.591,2,7,.286,471,793,.594,.593,349,638,.547,231,635,866,131,60,128,229,240,1297
214,Robbie Hummel\hummero01,SF,24,MIN,53,5,655,67,177,.379,32,89,.360,35,88,.398,.469,15,16,.938,35,97,132,23,16,2,10,57,181
215,Kris Humphries\humphkr01,PF,28,BOS,69,30,1376,231,461,.501,0,2,.000,231,459,.503,.501,117,144,.813,127,282,409,67,31,61,64,136,579
216,Serge Ibaka\ibakase01,PF,24,OKC,81,81,2666,524,978,.536,23,60,.383,501,918,.546,.548,156,199,.784,224,485,709,85,39,219,123,233,1227
217,Andre Iguodala\iguodan01,SF,30,GSW,63,63,2040,220,458,.480,62,175,.354,158,283,.558,.548,86,132,.652,53,240,293,263,95,18,100,103,588
218,Ersan Ilyasova\ilyaser01,PF,26,MIL,55,47,1478,237,579,.409,37,131,.282,200,448,.446,.441,107,130,.823,107,235,342,72,46,8,61,135,618
219,Kyrie Irving\irvinky01,PG,21,CLE,71,71,2496,532,1237,.430,123,344,.358,409,893,.458,.480,291,338,.861,52,207,259,433,108,23,190,163,1478
220,Royal Ivey\iveyro01,SG,32,OKC,2,0,5,0,2,.000,0,1,.000,0,1,.000,.000,0,0,,0,1,1,0,0,0,0,1,0
221,Jarrett Jack\jackja01,PG,30,CLE,80,31,2252,286,698,.410,63,185,.341,223,513,.435,.455,125,149,.839,22,201,223,324,56,22,133,133,760
222,Reggie Jackson\jacksre01,PG,23,OKC,80,36,2277,403,916,.440,83,245,.339,320,671,.477,.485,158,177,.893,43,270,313,331,85,9,168,142,1047
223,Stephen Jackson\jacksst02,SF,35,LAC,9,0,107,6,26,.231,1,14,.071,5,12,.417,.250,2,4,.500,2,8,10,5,6,1,6,11,15
224,Bernard James\jamesbe01,C,28,DAL,30,0,146,11,23,.478,0,1,.000,11,22,.500,.478,6,11,.545,15,27,42,3,3,8,10,24,28
225,Damion James\jamesda01,SF,26,SAS,5,1,50,2,9,.222,0,2,.000,2,7,.286,.222,2,2,1.000,1,11,12,3,0,1,1,3,6
226,LeBron James\jamesle01,PF,29,MIA,77,77,2902,767,1353,.567,116,306,.379,651,1047,.622,.610,439,585,.750,81,452,533,488,121,26,270,126,2089
227,Mike James\jamesmi01,PG,38,CHI,11,0,77,5,21,.238,1,5,.200,4,16,.250,.262,0,2,.000,0,7,7,17,2,0,5,11,11
228,Antawn Jamison\jamisan01,PF,37,LAC,22,0,248,29,92,.315,8,41,.195,21,51,.412,.359,18,25,.720,9,46,55,7,9,3,7,29,84
229,Othyus Jeffers\jeffeot01,SG,28,TOT,6,1,47,3,6,.500,0,2,.000,3,4,.750,.500,3,4,.750,1,8,9,1,0,0,1,3,9
229,Othyus Jeffers\jeffeot01,SG,28,SAS,4,1,34,3,5,.600,0,1,.000,3,4,.750,.600,1,2,.500,1,5,6,1,0,0,0,2,7
229,Othyus Jeffers\jeffeot01,SG,28,MIN,2,0,13,0,1,.000,0,1,.000,0,0,,.000,2,2,1.000,0,3,3,0,0,0,1,1,2
230,Al Jefferson\jeffeal01,C,29,CHA,73,73,2553,700,1376,.509,3,15,.200,697,1361,.512,.510,191,277,.690,156,636,792,155,67,79,124,176,1594
231,Richard Jefferson\jefferi01,SF,33,UTA,82,78,2213,294,654,.450,123,301,.409,171,353,.484,.544,120,162,.741,18,201,219,130,56,14,94,168,831
232,John Jenkins\jenkijo01,SG,22,ATL,13,0,158,16,42,.381,4,18,.222,12,24,.500,.429,4,4,1.000,3,19,22,11,1,1,11,11,40
233,Brandon Jennings\jennibr01,PG,24,DET,80,79,2728,423,1135,.373,154,457,.337,269,678,.397,.441,241,321,.751,59,185,244,609,101,8,215,157,1241
234,Jonas Jerebko\jerebjo01,PF,26,DET,64,0,741,98,208,.471,31,74,.419,67,134,.500,.546,43,59,.729,51,124,175,39,21,6,43,85,270
235,Amir Johnson\johnsam01,PF,26,TOR,77,72,2214,344,612,.562,20,66,.303,324,546,.593,.578,91,143,.636,172,333,505,115,56,88,123,271,799
236,Chris Johnson\johnsch04,SF,23,BOS,40,0,789,85,214,.397,43,127,.339,42,87,.483,.498,37,43,.860,31,66,97,31,27,4,22,63,250
237,James Johnson\johnsja01,SF,26,MEM,52,4,956,143,308,.464,22,87,.253,121,221,.548,.500,76,90,.844,60,106,166,111,42,57,66,102,384
238,Joe Johnson\johnsjo02,SG,32,BRK,79,79,2575,462,1018,.454,162,404,.401,300,614,.489,.533,159,195,.815,48,222,270,216,47,10,120,129,1245
239,Orlando Johnson\johnsor01,SG,24,TOT,45,0,392,36,113,.319,9,47,.191,27,66,.409,.358,19,26,.731,9,46,55,20,6,2,15,26,100
239,Orlando Johnson\johnsor01,SG,24,IND,38,0,342,33,96,.344,8,41,.195,25,55,.455,.385,17,22,.773,7,44,51,16,6,1,14,23,91
239,Orlando Johnson\johnsor01,SG,24,SAC,7,0,50,3,17,.176,1,6,.167,2,11,.182,.206,2,4,.500,2,2,4,4,0,1,1,3,9
240,Wesley Johnson\johnswe01,SF,26,LAL,79,62,2240,277,651,.425,100,271,.369,177,380,.466,.502,61,77,.792,70,278,348,124,86,77,90,207,715
241,Darius Johnson-Odom\johnsda03,SG,24,PHI,3,0,15,0,7,.000,0,3,.000,0,4,.000,.000,0,2,.000,0,2,2,1,1,0,2,3,0
242,James Jones\jonesja02,SF,33,MIA,20,6,236,31,68,.456,28,54,.519,3,14,.214,.662,7,11,.636,2,21,23,9,3,4,4,6,97
243,Perry Jones\jonespe01,PF,22,OKC,62,7,764,83,181,.459,22,61,.361,61,120,.508,.519,28,42,.667,28,86,114,26,14,19,21,62,216
244,Solomon Jones\jonesso01,PF,29,ORL,11,0,85,6,17,.353,0,0,,6,17,.353,.353,2,4,.500,8,8,16,2,2,2,2,12,14
245,Terrence Jones\joneste01,PF,22,HOU,76,71,2078,386,712,.542,31,101,.307,355,611,.581,.564,118,195,.605,162,366,528,87,53,99,71,139,921
246,DeAndre Jordan\jordade01,C,25,LAC,82,82,2870,348,515,.676,0,0,,348,515,.676,.676,160,374,.428,331,783,1114,74,80,203,123,264,856
247,Cory Joseph\josepco01,SG,22,SAS,68,19,936,126,265,.475,12,38,.316,114,227,.502,.498,79,96,.823,32,75,107,114,35,14,43,84,343
248,Chris Kaman\kamanch01,C,31,LAL,39,13,736,176,346,.509,0,3,.000,176,343,.513,.509,52,68,.765,54,175,229,58,11,40,74,93,404
249,Enes Kanter\kanteen01,C,21,UTA,80,37,2138,419,853,.491,0,1,.000,419,852,.492,.491,149,204,.730,222,376,598,75,28,42,144,230,987
250,Sergey Karasev\karasse01,SF,20,CLE,22,1,156,12,35,.343,4,19,.211,8,16,.500,.400,9,10,.900,0,16,16,6,3,1,11,22,37
251,Ryan Kelly\kellyry01,PF,22,LAL,59,25,1312,157,371,.423,48,142,.338,109,229,.476,.488,110,135,.815,42,177,219,95,32,45,47,147,472
252,Michael Kidd-Gilchrist\kiddgmi01,SF,20,CHA,62,62,1502,167,353,.473,1,9,.111,166,344,.483,.475,113,184,.614,109,215,324,52,43,39,60,145,448
253,Andrei Kirilenko\kirilan01,PF,32,BRK,45,4,857,82,160,.513,1,5,.200,81,155,.523,.516,61,119,.513,55,91,146,72,40,19,54,65,226
254,Brandon Knight\knighbr03,PG,22,MIL,72,69,2400,461,1092,.422,110,338,.325,351,754,.466,.473,259,323,.802,46,209,255,352,69,17,188,146,1291
255,Kyle Korver\korveky01,SG,32,ATL,71,71,2408,289,609,.475,185,392,.472,104,217,.479,.626,87,94,.926,22,260,282,208,70,24,102,147,850
256,Kosta Koufos\koufoko01,C,24,MEM,80,22,1349,227,459,.495,0,0,,227,459,.495,.495,60,93,.645,160,258,418,39,32,71,67,182,514
257,Viacheslav Kravtsov\kravtvi01,C,26,PHO,20,0,59,8,15,.533,0,0,,8,15,.533,.533,4,8,.500,9,8,17,1,0,1,6,7,20
258,Ognjen Kuzmic\kuzmiog01,C,23,GSW,21,0,92,5,13,.385,0,0,,5,13,.385,.385,5,11,.455,10,11,21,2,3,4,10,17,15
259,Doron Lamb\lambdo01,SG,22,ORL,53,0,695,63,160,.394,36,90,.400,27,70,.386,.506,29,36,.806,8,41,49,43,11,1,27,54,191
260,Jeremy Lamb\lambje01,SG,21,OKC,78,0,1538,263,609,.432,88,247,.356,175,362,.483,.504,51,64,.797,27,162,189,115,56,26,61,143,665
261,Carl Landry\landrca01,PF,30,SAC,18,1,233,31,60,.517,0,0,,31,60,.517,.517,14,17,.824,15,42,57,5,3,1,9,34,76
262,Shane Larkin\larkish01,PG,21,DAL,48,0,489,52,137,.380,12,38,.316,40,99,.404,.423,16,25,.640,11,31,42,71,26,1,39,46,132
263,Ty Lawson\lawsoty01,PG,26,DEN,62,61,2222,347,806,.431,72,202,.356,275,604,.455,.475,324,406,.798,40,175,215,543,100,10,200,113,1090
264,Ricky Ledo\ledori01,SG,21,DAL,11,0,33,6,17,.353,3,8,.375,3,9,.333,.441,4,4,1.000,0,2,2,2,1,0,2,2,19
265,Courtney Lee\leeco01,SG,28,TOT,79,47,1973,295,614,.480,72,194,.371,223,420,.531,.539,99,112,.884,29,158,187,115,65,28,73,127,761
265,Courtney Lee\leeco01,SG,28,BOS,30,0,504,90,183,.492,23,52,.442,67,131,.511,.555,18,22,.818,8,41,49,32,20,9,25,37,221
265,Courtney Lee\leeco01,SG,28,MEM,49,47,1469,205,431,.476,49,142,.345,156,289,.540,.532,81,90,.900,21,117,138,83,45,19,48,90,540
266,David Lee\leeda02,PF,30,GSW,69,67,2288,513,981,.523,0,1,.000,513,980,.523,.523,231,296,.780,182,461,643,147,48,26,152,206,1257
267,Alex Len\lenal01,C,20,PHO,42,3,362,33,78,.423,0,0,,33,78,.423,.423,20,31,.645,39,60,99,4,4,18,26,68,86
268,Kawhi Leonard\leonaka01,SF,22,SAS,66,65,1923,337,645,.522,69,182,.379,268,463,.579,.576,101,126,.802,76,336,412,133,114,50,80,127,844
269,Meyers Leonard\leoname01,C,21,POR,40,0,355,41,91,.451,0,6,.000,41,85,.482,.451,16,21,.762,26,85,111,18,7,5,15,76,98
270,Jon Leuer\leuerjo01,PF,24,MEM,49,0,642,121,246,.492,23,49,.469,98,197,.497,.539,37,47,.787,37,121,158,20,18,13,27,63,302
271,Rashard Lewis\lewisra02,SF,34,MIA,60,6,971,98,236,.415,46,134,.343,52,102,.510,.513,26,33,.788,24,86,110,57,53,8,35,90,268
272,DeAndre Liggins\liggide01,SG,25,MIA,1,0,1,1,1,1.000,0,0,,1,1,1.000,1.000,0,0,,1,0,1,0,0,0,0,0,2
273,Damian Lillard\lillada01,PG,23,POR,82,82,2937,553,1304,.424,218,554,.394,335,750,.447,.508,371,426,.871,35,253,288,457,64,22,193,197,1695
274,Jeremy Lin\linje01,PG,25,HOU,71,33,2054,295,662,.446,82,229,.358,213,433,.492,.508,218,265,.823,34,153,187,294,68,27,176,166,890
275,Shaun Livingston\livinsh01,PG,28,BRK,76,54,1974,235,487,.483,1,6,.167,234,481,.486,.484,158,191,.827,67,179,246,245,93,31,105,172,629
276,Brook Lopez\lopezbr01,C,25,BRK,17,17,533,129,229,.563,0,1,.000,129,228,.566,.563,94,115,.817,39,63,102,16,9,30,28,52,352
277,Robin Lopez\lopezro01,C,25,POR,82,82,2603,355,644,.551,0,1,.000,355,643,.552,.551,198,242,.818,326,374,700,73,25,139,84,196,908
278,Kevin Love\loveke01,PF,25,MIN,77,77,2797,650,1421,.457,190,505,.376,460,916,.502,.524,520,633,.821,224,739,963,341,59,35,196,136,2010
279,Kyle Lowry\lowryky01,PG,27,TOR,79,79,2862,457,1080,.423,190,500,.380,267,580,.460,.511,313,385,.813,88,281,369,586,121,15,194,267,1417
280,John Lucas III\lucasjo02,PG,31,UTA,42,6,591,62,190,.326,25,84,.298,37,106,.349,.392,10,16,.625,12,27,39,42,14,0,22,41,159
281,Shelvin Mack\macksh01,PG,23,ATL,73,11,1490,209,501,.417,62,184,.337,147,317,.464,.479,64,74,.865,21,139,160,271,50,2,89,100,544
282,Ian Mahinmi\mahinia01,C,27,IND,77,1,1248,91,189,.481,0,1,.000,91,188,.484,.481,90,145,.621,107,150,257,24,41,72,58,207,272
283,Shawn Marion\mariosh01,SF,35,DAL,76,76,2409,341,708,.482,58,162,.358,283,546,.518,.523,51,65,.785,132,365,497,124,90,37,95,125,791
284,Kendall Marshall\marshke01,PG,22,LAL,54,45,1564,170,419,.406,71,178,.399,99,241,.411,.490,19,36,.528,15,140,155,477,48,4,150,76,430
285,Cartier Martin\martica01,SF,29,TOT,59,6,870,111,264,.420,59,151,.391,52,113,.460,.532,48,65,.738,13,97,110,33,27,7,34,71,329
285,Cartier Martin\martica01,SF,29,ATL,53,6,822,106,256,.414,56,146,.384,50,110,.455,.523,46,61,.754,12,93,105,31,26,7,33,68,314
285,Cartier Martin\martica01,SF,29,CHI,6,0,48,5,8,.625,3,5,.600,2,3,.667,.813,2,4,.500,1,4,5,2,1,0,1,3,15
286,Kenyon Martin\martike01,PF,36,NYK,32,15,633,63,123,.512,0,1,.000,63,122,.516,.512,11,19,.579,36,98,134,50,25,27,26,85,137
287,Kevin Martin\martike02,SG,30,MIN,68,68,2177,440,1023,.430,115,297,.387,325,726,.448,.486,303,340,.891,34,169,203,121,66,6,106,123,1298
288,Roger Mason\masonro01,SG,33,MIA,25,2,260,25,67,.373,17,48,.354,8,19,.421,.500,7,7,1.000,1,21,22,19,6,1,9,26,74
289,Wesley Matthews\matthwe02,SG,27,POR,82,82,2780,445,1009,.441,201,511,.393,244,498,.490,.541,252,301,.837,51,238,289,197,76,14,110,176,1343
290,Jason Maxiell\maxieja01,PF,30,ORL,34,13,488,47,105,.448,0,0,,47,105,.448,.448,15,31,.484,28,58,86,9,8,20,14,47,109
291,Eric Maynor\maynoer01,PG,26,TOT,31,0,327,32,101,.317,12,37,.324,20,64,.313,.376,6,11,.545,9,30,39,52,9,3,29,17,82
291,Eric Maynor\maynoer01,PG,26,WAS,23,0,215,21,72,.292,8,25,.320,13,47,.277,.347,2,3,.667,7,17,24,40,5,1,17,13,52
291,Eric Maynor\maynoer01,PG,26,PHI,8,0,112,11,29,.379,4,12,.333,7,17,.412,.448,4,8,.500,2,13,15,12,4,2,12,4,30
292,O.J. Mayo\mayooj01,SG,26,MIL,52,23,1346,224,550,.407,84,227,.370,140,323,.433,.484,76,88,.864,24,100,124,113,28,13,95,111,608
293,Luc Mbah a Moute\mbahalu01,PF-SF,27,TOT,64,7,1003,87,193,.451,4,17,.235,83,176,.472,.461,46,67,.687,56,90,146,36,30,14,40,68,224
293,Luc Mbah a Moute\mbahalu01,SF,27,SAC,9,5,196,15,32,.469,1,3,.333,14,29,.483,.484,9,13,.692,9,18,27,15,9,5,4,18,40
293,Luc Mbah a Moute\mbahalu01,PF,27,MIN,55,2,807,72,161,.447,3,14,.214,69,147,.469,.457,37,54,.685,47,72,119,21,21,9,36,50,184
294,Ray McCallum\mccalra01,PG,22,SAC,45,10,897,113,300,.377,22,59,.373,91,241,.378,.413,32,43,.744,18,61,79,120,22,9,39,69,280
295,CJ McCollum\mccolcj01,SG,22,POR,38,0,476,74,178,.416,30,80,.375,44,98,.449,.500,23,34,.676,7,41,48,27,14,2,35,53,201
296,JaVale McGee\mcgeeja01,C,26,DEN,5,5,79,17,38,.447,0,0,,17,38,.447,.447,1,1,1.000,10,7,17,2,1,7,8,16,35
297,Ben McLemore\mclembe01,SG,20,SAC,82,55,2187,255,679,.376,95,297,.320,160,382,.419,.446,115,143,.804,53,182,235,82,45,18,96,201,720
298,Josh McRoberts\mcrobjo01,PF,26,CHA,78,78,2360,247,566,.436,105,291,.361,142,275,.516,.529,62,85,.729,85,288,373,333,58,46,83,189,661
299,Jodie Meeks\meeksjo01,SG,26,LAL,77,70,2556,413,892,.463,162,404,.401,251,488,.514,.554,221,258,.857,30,164,194,138,111,4,111,119,1209
300,Gal Mekel\mekelga01,PG,25,DAL,31,1,292,30,86,.349,5,20,.250,25,66,.379,.378,8,12,.667,5,22,27,63,4,1,31,31,73
301,Khris Middleton\middlkh01,SF,22,MIL,82,64,2460,376,854,.440,120,290,.414,256,564,.454,.511,118,137,.861,60,250,310,169,83,20,123,243,990
302,C.J. Miles\milescj01,SG,26,CLE,51,34,984,178,409,.435,83,211,.393,95,198,.480,.537,64,75,.853,18,85,103,52,46,15,44,103,503
303,Andre Miller\millean02,SG,37,TOT,58,2,982,106,231,.459,11,21,.524,95,210,.452,.483,60,77,.779,28,102,130,197,34,9,61,75,283
303,Andre Miller\millean02,SG,37,DEN,30,2,570,66,144,.458,9,18,.500,57,126,.452,.490,35,47,.745,16,57,73,100,15,7,33,32,176
303,Andre Miller\millean02,SG,37,WAS,28,0,412,40,87,.460,2,3,.667,38,84,.452,.471,25,30,.833,12,45,57,97,19,2,28,43,107
304,Darius Miller\milleda01,SF,23,NOP,45,7,723,73,166,.440,25,77,.325,48,89,.539,.515,29,36,.806,9,43,52,43,24,9,22,88,200
305,Mike Miller\millemi01,SF,33,MEM,82,4,1707,213,443,.481,107,233,.459,106,210,.505,.602,46,56,.821,30,177,207,130,26,5,77,95,579
306,Quincy Miller\millequ01,PF,21,DEN,52,16,789,94,256,.367,30,94,.319,64,162,.395,.426,39,55,.709,36,111,147,26,22,32,48,70,257
307,Patty Mills\millspa02,PG,25,SAS,81,2,1527,309,666,.464,135,318,.425,174,348,.500,.565,73,82,.890,34,135,169,149,68,9,63,114,826
308,Paul Millsap\millspa01,PF,28,ATL,74,73,2482,483,1047,.461,76,212,.358,407,835,.487,.498,286,391,.731,154,473,627,232,129,78,185,210,1328
309,Tony Mitchell\mitchto02,PF,21,DET,21,0,79,5,12,.417,1,1,1.000,4,11,.364,.458,11,19,.579,15,11,26,2,6,3,4,9,22
310,Tony Mitchell\mitchto03,SF,24,MIL,3,0,10,3,5,.600,0,1,.000,3,4,.750,.600,0,0,,1,0,1,1,1,0,0,0,6
311,Nazr Mohammed\mohamna01,C,36,CHI,80,1,562,54,126,.429,0,0,,54,126,.429,.429,16,30,.533,66,109,175,20,14,30,37,77,124
312,Greg Monroe\monrogr01,PF,23,DET,82,82,2690,504,1015,.497,0,1,.000,504,1014,.497,.497,241,367,.657,256,504,760,171,91,47,166,205,1249
313,E'Twaun Moore\mooreet01,SG,24,ORL,79,3,1506,195,456,.428,57,161,.354,138,295,.468,.490,52,68,.765,29,107,136,112,60,13,55,106,499
314,Darius Morris\morrida01,PG,23,TOT,27,0,313,39,96,.406,12,38,.316,27,58,.466,.469,17,26,.654,7,19,26,44,13,0,27,33,107
314,Darius Morris\morrida01,PG,23,PHI,12,0,193,29,67,.433,10,24,.417,19,43,.442,.507,15,21,.714,3,10,13,31,8,0,19,21,83
314,Darius Morris\morrida01,PG,23,LAC,10,0,54,4,13,.308,0,7,.000,4,6,.667,.308,1,2,.500,0,5,5,5,2,0,2,9,9
314,Darius Morris\morrida01,PG,23,MEM,5,0,66,6,16,.375,2,7,.286,4,9,.444,.438,1,3,.333,4,4,8,8,3,0,6,3,15
315,Marcus Morris\morrima03,SF,24,PHO,82,1,1800,288,651,.442,99,260,.381,189,391,.483,.518,121,159,.761,84,235,319,88,72,18,95,157,796
316,Markieff Morris\morrima02,PF,24,PHO,81,0,2153,411,845,.486,34,108,.315,377,737,.512,.507,259,327,.792,139,346,485,144,68,51,147,232,1115
317,Anthony Morrow\morroan01,SG,28,NOP,76,9,1426,238,520,.458,88,195,.451,150,325,.462,.542,72,87,.828,29,111,140,59,38,12,51,102,636
318,Donatas Motiejunas\motiedo01,PF,23,HOU,62,3,952,131,296,.443,21,84,.250,110,212,.519,.478,58,96,.604,60,165,225,34,20,21,49,132,341
319,Arnett Moultrie\moultar01,PF,23,PHI,12,2,187,16,38,.421,0,0,,16,38,.421,.421,4,5,.800,11,24,35,2,8,4,7,22,36
320,Timofey Mozgov\mozgoti01,C,27,DEN,82,30,1770,285,545,.523,4,24,.167,281,521,.539,.527,196,260,.754,171,357,528,62,27,100,122,213,770
321,Shabazz Muhammad\muhamsh01,SG,21,MIN,37,0,290,57,124,.460,3,11,.273,54,113,.478,.472,26,40,.650,24,29,53,6,8,1,16,24,143
322,Byron Mullens\mulleby01,C,24,TOT,45,0,414,73,165,.442,33,89,.371,40,76,.526,.542,10,20,.500,24,68,92,14,15,11,27,64,189
322,Byron Mullens\mulleby01,C,24,LAC,27,0,167,26,64,.406,13,39,.333,13,25,.520,.508,2,6,.333,7,25,32,6,6,3,13,33,67
322,Byron Mullens\mulleby01,C,24,PHI,18,0,247,47,101,.465,20,50,.400,27,51,.529,.564,8,14,.571,17,43,60,8,9,8,14,31,122
323,Erik Murphy\murpher01,C,23,CHI,24,0,62,3,13,.231,0,3,.000,3,10,.300,.231,0,0,,2,6,8,2,0,4,2,7,6
324,Toure' Murry\murryto01,PG,24,NYK,51,0,373,56,129,.434,5,12,.417,51,117,.436,.453,23,39,.590,13,31,44,49,19,1,34,46,140
325,Mike Muscala\muscami01,PF,22,ATL,20,0,215,31,73,.425,0,3,.000,31,70,.443,.425,14,14,1.000,17,35,52,7,3,10,12,29,76
326,Hamady N'Diaye\ndiayha01,C,27,SAC,14,0,74,3,9,.333,0,0,,3,9,.333,.333,0,1,.000,5,13,18,3,0,4,3,15,6
327,Steve Nash*\nashst01,PG,39,LAL,15,10,313,36,94,.383,8,24,.333,28,70,.400,.426,22,24,.917,4,25,29,86,7,2,31,18,102
328,Gary Neal\nealga01,SG,29,TOT,52,3,1114,193,471,.410,68,180,.378,125,291,.430,.482,94,105,.895,10,80,90,83,18,0,64,65,548
328,Gary Neal\nealga01,SG,29,MIL,30,2,607,108,277,.390,40,111,.360,68,166,.410,.462,45,54,.833,8,42,50,46,7,0,39,26,301
328,Gary Neal\nealga01,SG,29,CHA,22,1,507,85,194,.438,28,69,.406,57,125,.456,.510,49,51,.961,2,38,40,37,11,0,25,39,247
329,Nemanja Nedovic\nedovne01,SG,22,GSW,24,0,142,8,39,.205,3,18,.167,5,21,.238,.244,7,8,.875,3,12,15,13,0,1,13,13,26
330,Jameer Nelson\nelsoja01,PG,31,ORL,68,68,2179,294,747,.394,136,391,.348,158,356,.444,.485,96,112,.857,29,202,231,476,52,5,166,146,820
331,Andrew Nicholson\nichoan01,PF,24,ORL,76,5,1174,180,420,.429,28,89,.315,152,331,.459,.462,47,57,.825,53,202,255,25,18,23,51,150,435
332,Joakim Noah\noahjo01,C,28,CHI,80,80,2820,380,800,.475,0,2,.000,380,798,.476,.475,247,335,.737,282,618,900,431,99,121,194,245,1007
333,Steve Novak\novakst01,PF,30,TOR,54,1,540,60,146,.411,52,122,.426,8,24,.333,.589,6,6,1.000,8,50,58,13,12,4,5,44,178
334,Dirk Nowitzki\nowitdi01,PF,35,DAL,80,80,2628,633,1273,.497,131,329,.398,502,944,.532,.549,338,376,.899,40,458,498,216,73,45,117,165,1735
335,James Nunnally\nunnaja01,SF,23,TOT,13,0,165,15,46,.326,8,25,.320,7,21,.333,.413,6,9,.667,1,18,19,8,6,2,7,11,44
335,James Nunnally\nunnaja01,SF,23,ATL,4,0,54,6,18,.333,3,10,.300,3,8,.375,.417,3,4,.750,1,7,8,2,1,1,4,2,18
335,James Nunnally\nunnaja01,SF,23,PHI,9,0,111,9,28,.321,5,15,.333,4,13,.308,.411,3,5,.600,0,11,11,6,5,1,3,9,26
336,Jermaine O'Neal\onealje01,PF,35,GSW,44,13,883,125,248,.504,0,0,,125,248,.504,.504,99,132,.750,85,157,242,25,14,40,52,102,349
337,Kyle O'Quinn\oquinky01,C,23,ORL,69,19,1188,186,371,.501,0,3,.000,186,368,.505,.501,57,83,.687,100,264,364,78,39,88,78,165,429
338,Greg Oden\odengr01,C,26,MIA,23,6,212,27,49,.551,0,0,,27,49,.551,.551,13,23,.565,23,31,54,1,7,13,12,52,67
339,Victor Oladipo\oladivi01,PG,21,ORL,80,44,2487,392,936,.419,74,226,.327,318,710,.448,.458,248,318,.780,43,286,329,327,129,37,256,210,1106
340,Kelly Olynyk\olynyke01,C,22,BOS,70,9,1400,234,502,.466,40,114,.351,194,388,.500,.506,99,122,.811,140,225,365,109,35,27,106,227,607
341,Arinze Onuaku\onuakar01,PF,26,TOT,5,0,30,1,5,.200,0,0,,1,5,.200,.200,1,2,.500,2,6,8,3,0,0,1,3,3
341,Arinze Onuaku\onuakar01,PF,26,NOP,3,0,25,1,4,.250,0,0,,1,4,.250,.250,1,2,.500,2,5,7,3,0,0,1,3,3
341,Arinze Onuaku\onuakar01,PF,26,CLE,2,0,5,0,1,.000,0,0,,0,1,.000,.000,0,0,,0,1,1,0,0,0,0,0,0
342,Daniel Orton\ortonda01,C,23,PHI,22,4,251,21,47,.447,0,0,,21,47,.447,.447,23,30,.767,16,45,61,15,6,16,18,38,65
343,Travis Outlaw\outlatr01,SF,29,SAC,63,4,1065,130,326,.399,41,117,.350,89,209,.426,.462,42,52,.808,36,132,168,48,20,19,26,94,343
344,Zaza Pachulia\pachuza01,C,29,MIL,53,43,1325,149,349,.427,0,1,.000,149,348,.428,.427,110,130,.846,141,192,333,136,45,14,92,124,408
345,Jannero Pargo\pargoja01,PG,34,CHA,29,0,242,52,118,.441,24,60,.400,28,58,.483,.542,8,11,.727,1,19,20,52,14,1,26,17,136
346,Tony Parker\parketo01,PG,31,SAS,68,68,1997,456,914,.499,25,67,.373,431,847,.509,.513,197,243,.811,17,138,155,388,36,9,151,86,1134
347,Chandler Parsons\parsoch01,SF,25,HOU,74,74,2783,466,987,.472,130,351,.370,336,636,.528,.538,164,221,.742,69,340,409,298,88,29,144,168,1226
348,Patrick Patterson\pattepa01,PF,24,TOT,65,13,1533,225,489,.460,55,151,.364,170,338,.503,.516,50,71,.704,117,225,342,78,55,37,65,159,555
348,Patrick Patterson\pattepa01,PF,24,SAC,17,6,415,50,122,.410,9,39,.231,41,83,.494,.447,9,16,.563,34,65,99,15,13,3,16,39,118
348,Patrick Patterson\pattepa01,PF,24,TOR,48,7,1118,175,367,.477,46,112,.411,129,255,.506,.540,41,55,.745,83,160,243,63,42,34,49,120,437
349,Chris Paul\paulch01,PG,28,LAC,62,62,2171,406,870,.467,78,212,.368,328,658,.498,.511,295,345,.855,38,230,268,663,154,4,145,157,1185
350,Nikola Pekovic\pekovni01,C,28,MIN,54,54,1663,379,701,.541,0,0,,379,701,.541,.541,186,249,.747,206,262,468,50,30,23,84,129,944
351,Kendrick Perkins\perkike01,C,29,OKC,62,62,1207,87,193,.451,0,1,.000,87,192,.453,.451,37,67,.552,82,223,305,67,26,32,90,177,211
352,Paul Pierce\piercpa01,SF,36,BRK,75,68,2098,321,712,.451,112,300,.373,209,412,.507,.529,256,310,.826,26,322,348,178,86,31,153,190,1010
353,Dexter Pittman\pittmde01,C,25,ATL,2,0,3,0,1,.000,0,0,,0,1,.000,.000,0,2,.000,3,0,3,0,0,0,0,0,0
354,Mason Plumlee\plumlma01,C,23,BRK,70,22,1275,199,302,.659,0,3,.000,199,299,.666,.659,122,195,.626,99,209,308,60,49,55,77,171,520
355,Miles Plumlee\plumlmi01,C,25,PHO,80,79,1964,286,553,.517,0,0,,286,553,.517,.517,74,132,.561,198,428,626,43,50,90,111,185,646
356,Quincy Pondexter\pondequ01,SG,25,MEM,15,2,270,31,79,.392,11,34,.324,20,45,.444,.462,21,26,.808,10,16,26,20,5,1,15,18,94
357,Otto Porter\porteot01,SF,20,WAS,37,0,319,33,91,.363,4,21,.190,29,70,.414,.385,8,12,.667,21,36,57,10,8,1,14,26,78
358,Josh Powell\poweljo01,PF,31,HOU,1,0,19,2,6,.333,0,0,,2,6,.333,.333,0,0,,0,5,5,0,0,1,1,1,4
359,Phil Pressey\pressph01,PG,22,BOS,75,11,1132,78,253,.308,28,106,.264,50,147,.340,.364,29,45,.644,20,85,105,241,68,5,87,97,213
360,A.J. Price\priceaj01,SG,27,MIN,28,0,99,19,46,.413,6,22,.273,13,24,.542,.478,0,2,.000,1,9,10,13,1,0,7,5,44
361,Ronnie Price\pricero01,SG,30,ORL,31,2,377,28,92,.304,9,43,.209,19,49,.388,.353,9,13,.692,8,35,43,66,25,2,26,50,74
362,Pablo Prigioni\prigipa01,PG,36,NYK,66,27,1283,88,191,.461,65,140,.464,23,51,.451,.631,11,12,.917,36,93,129,228,67,2,60,132,252
363,Tayshaun Prince\princta01,SF,33,MEM,76,76,1948,200,492,.407,20,69,.290,180,423,.426,.427,34,60,.567,32,202,234,119,39,19,41,63,454
364,Miroslav Raduljica\radulmi01,C,26,MIL,48,2,465,68,126,.540,0,0,,68,126,.540,.540,45,55,.818,54,54,108,23,7,13,28,84,181
365,Anthony Randolph\randoan01,PF,24,DEN,43,5,527,68,176,.386,18,61,.295,50,115,.435,.438,52,69,.754,20,102,122,32,26,19,39,64,206
366,Shavlik Randolph\randosh01,PF,30,PHO,14,0,95,7,14,.500,0,0,,7,14,.500,.500,6,11,.545,7,18,25,1,3,1,5,15,20
367,Zach Randolph\randoza01,PF,32,MEM,79,79,2705,560,1198,.467,2,20,.100,558,1178,.474,.468,250,337,.742,265,530,795,200,54,23,183,210,1372
368,J.J. Redick\redicjj01,SG,29,LAC,35,34,987,181,398,.455,73,185,.395,108,213,.507,.546,97,106,.915,9,65,74,78,28,3,42,65,532
369,Glen Rice\ricegl02,SG,23,WAS,11,1,109,11,37,.297,5,17,.294,6,20,.300,.365,5,7,.714,4,16,20,7,6,1,9,7,32
370,Luke Ridnour\ridnolu01,PG,32,TOT,61,14,1141,126,327,.385,37,108,.343,89,219,.406,.442,17,26,.654,23,74,97,176,32,8,66,92,306
370,Luke Ridnour\ridnolu01,PG,32,MIL,36,12,763,84,219,.384,25,68,.368,59,151,.391,.441,13,19,.684,15,47,62,122,23,2,46,55,206
370,Luke Ridnour\ridnolu01,PG,32,CHA,25,2,378,42,108,.389,12,40,.300,30,68,.441,.444,4,7,.571,8,27,35,54,9,6,20,37,100
371,Austin Rivers\riverau01,PG,21,NOP,69,4,1339,192,474,.405,36,99,.364,156,375,.416,.443,110,173,.636,26,103,129,160,45,9,77,134,530
372,Andre Roberson\roberan03,SG,22,OKC,40,16,399,33,68,.485,2,13,.154,31,55,.564,.500,7,10,.700,36,58,94,15,19,10,19,74,75
373,Brian Roberts\roberbr01,PG,28,NOP,72,42,1667,244,581,.420,64,178,.360,180,403,.447,.475,125,133,.940,17,119,136,234,43,7,95,132,677
374,Nate Robinson\robinna01,PG,29,DEN,44,1,866,164,383,.428,58,154,.377,106,229,.463,.504,71,85,.835,21,60,81,112,36,4,58,92,457
375,Thomas Robinson\robinth01,PF,22,POR,70,0,873,141,293,.481,0,1,.000,141,292,.483,.481,57,101,.564,105,202,307,34,23,20,57,131,339
376,Rajon Rondo\rondora01,PG,27,BOS,30,30,998,141,350,.403,26,90,.289,115,260,.442,.440,42,67,.627,22,142,164,294,40,2,99,65,350
377,Derrick Rose\rosede01,PG,25,CHI,10,10,311,58,164,.354,16,47,.340,42,117,.359,.402,27,32,.844,9,23,32,43,5,1,34,15,159
378,Terrence Ross\rosste01,SG,22,TOR,81,62,2159,318,751,.423,161,408,.395,157,343,.458,.531,82,98,.837,43,209,252,79,64,27,88,183,879
379,Ricky Rubio\rubiori01,PG,23,MIN,82,82,2638,255,670,.381,44,133,.331,211,537,.393,.413,227,283,.802,61,281,342,704,191,11,221,218,781
380,Brandon Rush\rushbr01,SG,28,UTA,38,0,418,30,90,.333,16,47,.340,14,43,.326,.422,3,5,.600,5,39,44,24,5,9,20,31,79
381,Robert Sacre\sacrero01,C,24,LAL,65,13,1089,143,300,.477,0,0,,143,300,.477,.477,64,94,.681,82,172,254,51,24,47,44,134,350
382,John Salmons\salmojo01,SG-SF,34,TOT,78,8,1726,150,413,.363,63,163,.387,87,250,.348,.439,40,52,.769,20,143,163,147,47,19,54,124,403
382,John Salmons\salmojo01,SF,34,SAC,18,8,445,41,117,.350,16,42,.381,25,75,.333,.419,7,7,1.000,8,38,46,44,12,8,14,32,105
382,John Salmons\salmojo01,SG,34,TOR,60,0,1281,109,296,.368,47,121,.388,62,175,.354,.448,33,45,.733,12,105,117,103,35,11,40,92,298
383,Larry Sanders\sandela01,C,25,MIL,23,20,584,76,162,.469,0,1,.000,76,161,.472,.469,26,55,.473,60,105,165,19,18,40,26,74,178
384,Dennis Schroder\schrode01,PG,20,ATL,49,0,641,72,188,.383,10,42,.238,62,146,.425,.410,29,43,.674,5,55,60,93,17,0,61,54,183
385,Luis Scola\scolalu01,PF,33,IND,82,2,1399,263,560,.470,1,7,.143,262,553,.474,.471,99,136,.728,86,305,391,81,26,16,108,164,626
386,Mike Scott\scottmi01,PF,25,ATL,80,6,1482,301,628,.479,62,200,.310,239,428,.558,.529,103,132,.780,62,222,284,75,30,7,79,121,767
387,Thabo Sefolosha\sefolth01,SG,29,OKC,61,61,1584,141,340,.415,48,152,.316,93,188,.495,.485,53,69,.768,50,170,220,94,79,17,55,90,383
388,Kevin Seraphin\serapke01,C,24,WAS,53,1,578,111,220,.505,0,0,,111,220,.505,.505,27,31,.871,53,75,128,17,3,26,41,103,249
389,Ramon Sessions\sessira01,PG,27,TOT,83,19,2214,330,769,.429,35,124,.282,295,645,.457,.452,326,404,.807,38,165,203,340,49,9,148,90,1021
389,Ramon Sessions\sessira01,PG,27,CHA,55,7,1305,190,465,.409,15,68,.221,175,397,.441,.425,183,234,.782,22,95,117,206,33,6,93,50,578
389,Ramon Sessions\sessira01,PG,27,MIL,28,12,909,140,304,.461,20,56,.357,120,248,.484,.493,143,170,.841,16,70,86,134,16,3,55,40,443
390,Mustafa Shakur\shakumu01,PG,29,OKC,3,0,11,0,3,.000,0,1,.000,0,2,.000,.000,1,2,.500,0,0,0,4,0,0,2,2,1
391,Tornike Shengelia\shengto01,SF,22,TOT,26,0,154,13,28,.464,0,6,.000,13,22,.591,.464,3,8,.375,4,12,16,14,3,1,12,18,29
391,Tornike Shengelia\shengto01,SF,22,BRK,17,0,137,11,24,.458,0,6,.000,11,18,.611,.458,3,8,.375,4,10,14,12,2,1,11,16,25
391,Tornike Shengelia\shengto01,SF,22,CHI,9,0,17,2,4,.500,0,0,,2,4,.500,.500,0,0,,0,2,2,2,1,0,1,2,4
392,Iman Shumpert\shumpim01,SG,23,NYK,74,58,1962,183,484,.378,76,228,.333,107,256,.418,.457,53,71,.746,81,227,308,129,92,13,79,209,495
393,Alexey Shved\shvedal01,SG,25,MIN,63,0,664,76,237,.321,30,102,.294,46,135,.341,.384,68,90,.756,21,60,81,68,26,16,48,36,250
394,Henry Sims\simshe01,C,23,TOT,46,25,875,130,274,.474,0,1,.000,130,273,.476,.474,90,121,.744,104,133,237,52,28,20,41,116,350
394,Henry Sims\simshe01,C,23,CLE,20,0,168,18,45,.400,0,0,,18,45,.400,.400,8,14,.571,22,34,56,5,5,7,8,32,44
394,Henry Sims\simshe01,C,23,PHI,26,25,707,112,229,.489,0,1,.000,112,228,.491,.489,82,107,.766,82,99,181,47,23,13,33,84,306
395,Kyle Singler\singlky01,SF,25,DET,82,36,2337,269,602,.447,94,246,.382,175,356,.492,.525,152,184,.826,116,187,303,75,61,38,79,211,784
396,Chris Singleton\singlch01,SF,24,WAS,25,0,250,25,67,.373,7,19,.368,18,48,.375,.425,18,25,.720,18,37,55,6,9,3,17,25,75
397,Peyton Siva\sivape01,SG,23,DET,24,0,224,18,57,.316,7,25,.280,11,32,.344,.377,11,15,.733,2,12,14,34,9,1,18,27,54
398,Donald Sloan\sloando01,SG,26,IND,48,1,392,44,117,.376,10,42,.238,34,75,.453,.419,12,20,.600,4,40,44,50,10,1,22,19,110
399,Chris Smith\smithch05,PG,26,NYK,2,0,2,0,0,,0,0,,0,0,,,0,0,,0,0,0,0,0,0,0,0,0
400,Greg Smith\smithgr02,C,23,HOU,11,0,100,18,28,.643,0,0,,18,28,.643,.643,2,5,.400,11,16,27,0,1,2,5,17,38
401,Ish Smith\smithis01,PG,25,PHO,70,1,1006,119,281,.423,1,23,.043,118,258,.457,.425,22,39,.564,31,98,129,179,49,13,65,66,261
402,J.R. Smith\smithjr01,SF,28,NYK,74,37,2421,396,955,.415,189,480,.394,207,475,.436,.514,90,138,.652,35,261,296,219,65,20,108,196,1071
403,Jason Smith\smithja02,PF,27,NOP,31,27,830,131,282,.465,0,0,,131,282,.465,.465,39,50,.780,51,130,181,29,11,29,28,100,301
404,Josh Smith\smithjo03,SF,28,DET,77,76,2730,517,1233,.419,70,265,.264,447,968,.462,.448,160,301,.532,102,418,520,252,105,110,199,197,1264
405,Tony Snell\snellto01,SG,22,CHI,77,12,1231,129,336,.384,57,178,.320,72,158,.456,.469,31,41,.756,19,105,124,68,29,15,44,84,346
406,James Southerland\southja01,SF,23,TOT,4,0,30,5,15,.333,3,6,.500,2,9,.222,.433,1,2,.500,0,8,8,0,1,2,1,3,14
406,James Southerland\southja01,SF,23,CHA,1,0,3,0,3,.000,0,1,.000,0,2,.000,.000,0,0,,0,0,0,0,0,0,0,0,0
406,James Southerland\southja01,SF,23,NOP,3,0,27,5,12,.417,3,5,.600,2,7,.286,.542,1,2,.500,0,8,8,0,1,2,1,3,14
407,Marreese Speights\speigma01,C,26,GSW,79,3,982,195,442,.441,8,31,.258,187,411,.455,.450,110,134,.821,101,189,290,32,10,34,66,148,508
408,Tiago Splitter\splitti01,C,29,SAS,59,50,1271,181,346,.523,0,3,.000,181,343,.528,.523,121,173,.699,123,240,363,90,29,31,75,117,483
409,D.J. Stephens\stephdj01,SG,23,MIL,3,0,15,3,7,.429,0,0,,3,7,.429,.429,1,1,1.000,1,4,5,0,0,0,0,0,7
410,Lance Stephenson\stephla01,SG,23,IND,78,78,2752,427,870,.491,86,244,.352,341,626,.545,.540,140,197,.711,95,463,558,359,54,7,210,195,1080
411,Greg Stiemsma\stiemgr01,C,28,NOP,55,20,1007,70,122,.574,0,1,.000,70,121,.579,.574,19,32,.594,72,154,226,36,35,57,44,169,159
412,Julyan Stone\stoneju01,SG,25,TOR,21,0,120,7,17,.412,2,8,.250,5,9,.556,.471,2,3,.667,2,18,20,12,3,0,5,13,18
413,Amar'e Stoudemire\stoudam01,C,31,NYK,65,21,1466,311,558,.557,0,0,,311,558,.557,.557,150,203,.739,112,208,320,34,23,37,91,159,772
414,Rodney Stuckey\stuckro01,SG,27,DET,73,5,1950,372,853,.436,24,88,.273,348,765,.455,.450,244,292,.836,39,130,169,152,54,10,125,131,1012
415,Jared Sullinger\sullija01,PF,21,BOS,74,44,2041,384,899,.427,56,208,.269,328,691,.475,.458,158,203,.778,241,360,601,118,35,49,119,251,982
416,Jeffery Taylor\tayloje03,SF,24,CHA,26,8,629,82,218,.376,18,67,.269,64,151,.424,.417,26,47,.553,15,45,60,22,13,5,25,62,208
417,Tyshawn Taylor\tayloty01,PG,23,BRK,23,3,270,31,91,.341,3,12,.250,28,79,.354,.357,24,30,.800,3,12,15,36,12,1,31,29,89
418,Jeff Teague\teaguje01,PG,25,ATL,79,79,2542,456,1040,.438,74,225,.329,382,815,.469,.474,318,376,.846,34,174,208,528,89,17,232,158,1304
419,Marquis Teague\teaguma01,SG,20,TOT,40,3,443,38,119,.319,5,18,.278,33,101,.327,.340,26,35,.743,1,39,40,58,10,5,39,46,107
419,Marquis Teague\teaguma01,SG,20,CHI,19,2,242,16,66,.242,2,10,.200,14,56,.250,.258,11,16,.688,1,18,19,28,2,4,17,25,45
419,Marquis Teague\teaguma01,SG,20,BRK,21,1,201,22,53,.415,3,8,.375,19,45,.422,.443,15,19,.789,0,21,21,30,8,1,22,21,62
420,Mirza Teletovic\teletmi01,SF,28,BRK,72,7,1396,221,529,.418,136,349,.390,85,180,.472,.546,44,62,.710,60,206,266,57,29,23,54,143,622
421,Garrett Temple\templga01,SG,27,WAS,75,0,638,51,141,.362,6,29,.207,45,112,.402,.383,30,43,.698,21,47,68,72,35,11,42,72,138
422,Jason Terry\terryja01,PG,36,BRK,35,0,570,55,152,.362,39,103,.379,16,49,.327,.490,10,15,.667,4,33,37,56,13,0,27,48,159
423,Hasheem Thabeet\thabeha01,C,26,OKC,23,0,192,13,23,.565,0,0,,13,23,.565,.565,1,5,.200,9,31,40,1,4,9,14,47,27
424,Adonis Thomas\thomaad01,SF,20,TOT,6,1,37,6,14,.429,1,5,.200,5,9,.556,.464,1,1,1.000,0,3,3,3,0,0,1,6,14
424,Adonis Thomas\thomaad01,SF,20,ORL,4,0,24,3,9,.333,0,3,.000,3,6,.500,.333,1,1,1.000,0,3,3,2,0,0,0,2,7
424,Adonis Thomas\thomaad01,SF,20,PHI,2,1,13,3,5,.600,1,2,.500,2,3,.667,.700,0,0,,0,0,0,1,0,0,1,4,7
425,Isaiah Thomas\thomais02,PG,24,SAC,72,54,2497,496,1096,.453,127,364,.349,369,732,.504,.510,346,407,.850,47,163,210,454,93,8,213,185,1465
426,Lance Thomas\thomala01,SF,25,NOP,5,0,42,2,9,.222,0,0,,2,9,.222,.222,2,4,.500,2,5,7,3,0,0,2,4,6
427,Malcolm Thomas\thomama01,PF,25,TOT,8,0,63,7,16,.438,1,4,.250,6,12,.500,.469,0,2,.000,5,16,21,2,0,3,9,5,15
427,Malcolm Thomas\thomama01,PF,25,SAS,1,0,15,1,4,.250,0,0,,1,4,.250,.250,0,2,.000,1,8,9,0,0,2,1,0,2
427,Malcolm Thomas\thomama01,PF,25,UTA,7,0,48,6,12,.500,1,4,.250,5,8,.625,.542,0,0,,4,8,12,2,0,1,8,5,13
428,Hollis Thompson\thompho01,SF,22,PHI,77,41,1742,171,372,.460,67,167,.401,104,205,.507,.550,52,73,.712,73,174,247,73,53,12,60,144,461
429,Jason Thompson\thompja02,PF,27,SAC,82,61,2007,251,496,.506,0,0,,251,496,.506,.506,84,145,.579,153,374,527,53,32,56,95,251,586
430,Klay Thompson\thompkl01,SG,23,GSW,81,81,2868,559,1259,.444,223,535,.417,336,724,.464,.533,147,185,.795,38,211,249,181,74,37,135,234,1488
431,Tristan Thompson\thomptr01,PF,22,CLE,82,82,2594,363,761,.477,0,1,.000,363,760,.478,.477,235,339,.693,269,485,754,72,42,35,108,188,961
432,Marcus Thornton\thornma01,SG,26,TOT,72,27,1741,252,639,.394,109,316,.345,143,323,.443,.480,90,112,.804,57,141,198,77,58,11,67,110,703
432,Marcus Thornton\thornma01,SG,26,SAC,46,26,1121,142,373,.381,57,179,.318,85,194,.438,.457,42,52,.808,39,85,124,47,31,8,38,74,383
432,Marcus Thornton\thornma01,SG,26,BRK,26,1,620,110,266,.414,52,137,.380,58,129,.450,.511,48,60,.800,18,56,74,30,27,3,29,36,320
433,Jamaal Tinsley\tinslja01,PG,35,UTA,8,5,110,4,20,.200,1,15,.067,3,5,.600,.225,0,0,,2,9,11,23,2,0,9,10,9
434,Anthony Tolliver\tollian01,PF,28,CHA,64,9,1298,129,307,.420,102,247,.413,27,60,.450,.586,33,41,.805,33,135,168,42,19,15,23,82,393
435,P.J. Tucker\tuckepj01,SF,28,PHO,81,81,2490,265,615,.431,74,191,.387,191,424,.450,.491,156,201,.776,161,368,529,141,110,23,102,204,760
436,Ronny Turiaf\turiaro01,C,31,MIN,31,10,606,64,107,.598,0,0,,64,107,.598,.598,21,50,.420,55,119,174,24,8,50,24,65,149
437,Hedo Turkoglu\turkohe01,SF,34,LAC,38,0,392,42,109,.385,22,50,.440,20,59,.339,.486,9,18,.500,11,78,89,33,19,10,16,50,115
438,Evan Turner\turneev01,SF,25,TOT,81,56,2457,434,1021,.425,50,156,.321,384,865,.444,.450,213,262,.813,62,346,408,262,67,7,189,195,1131
438,Evan Turner\turneev01,SF,25,PHI,54,54,1886,356,831,.428,38,132,.288,318,699,.455,.451,189,228,.829,50,272,322,198,56,5,155,147,939
438,Evan Turner\turneev01,SF,25,IND,27,2,571,78,190,.411,12,24,.500,66,166,.398,.442,24,34,.706,12,74,86,64,11,2,34,48,192
439,Jeremy Tyler\tylerje01,C,22,NYK,41,0,398,60,116,.517,0,0,,60,116,.517,.517,26,48,.542,38,71,109,8,6,20,26,70,146
440,Ekpe Udoh\udohek01,PF,26,MIL,42,14,804,57,143,.399,0,0,,57,143,.399,.399,30,47,.638,61,87,148,31,15,44,38,96,144
441,Beno Udrih\udrihbe01,SG,31,TOT,41,12,643,78,178,.438,19,42,.452,59,136,.434,.492,25,30,.833,10,49,59,116,23,4,47,50,200
441,Beno Udrih\udrihbe01,SG,31,NYK,31,12,588,68,160,.425,17,40,.425,51,120,.425,.478,20,24,.833,10,47,57,110,22,3,42,46,173
441,Beno Udrih\udrihbe01,SG,31,MEM,10,0,55,10,18,.556,2,2,1.000,8,16,.500,.611,5,6,.833,0,2,2,6,1,1,5,4,27
442,Jonas Valanciunas\valanjo01,C,21,TOR,81,81,2282,359,676,.531,0,1,.000,359,675,.532,.531,198,260,.762,226,488,714,57,24,71,136,249,916
443,Anderson Varejao\varejan01,C,31,CLE,65,29,1800,227,459,.495,0,7,.000,227,452,.502,.495,92,135,.681,187,442,629,140,69,39,72,164,546
444,Jarvis Varnado\varnaja01,PF,25,TOT,24,0,339,36,60,.600,0,0,,36,60,.600,.600,27,52,.519,19,44,63,13,10,29,10,62,99
444,Jarvis Varnado\varnaja01,PF,25,CHI,1,0,2,0,0,,0,0,,0,0,,,0,0,,0,0,0,0,0,0,0,1,0
444,Jarvis Varnado\varnaja01,PF,25,PHI,23,0,337,36,60,.600,0,0,,36,60,.600,.600,27,52,.519,19,44,63,13,10,29,10,61,99
445,Greivis Vasquez\vasqugr01,SG-PG,27,TOT,79,23,1779,277,658,.421,109,289,.377,168,369,.455,.504,95,108,.880,20,153,173,323,31,5,128,143,758
445,Greivis Vasquez\vasqugr01,PG,27,SAC,18,18,465,65,150,.433,16,50,.320,49,100,.490,.487,30,32,.938,5,29,34,95,6,1,27,38,176
445,Greivis Vasquez\vasqugr01,SG,27,TOR,61,5,1314,212,508,.417,93,239,.389,119,269,.442,.509,65,76,.855,15,124,139,228,25,4,101,105,582
446,Jan Vesely\veselja01,PF,23,TOT,54,1,776,89,173,.514,0,0,,89,173,.514,.514,19,56,.339,81,110,191,21,53,35,36,121,197
446,Jan Vesely\veselja01,PF,23,WAS,33,1,470,48,92,.522,0,0,,48,92,.522,.522,8,30,.267,53,60,113,10,26,19,22,64,104
446,Jan Vesely\veselja01,PF,23,DEN,21,0,306,41,81,.506,0,0,,41,81,.506,.506,11,26,.423,28,50,78,11,27,16,14,57,93
447,Charlie Villanueva\villach01,PF,29,DET,20,0,180,35,92,.380,14,56,.250,21,36,.583,.457,8,14,.571,6,28,34,6,4,5,7,16,92
448,Nikola Vucevic\vucevni01,C,23,ORL,57,57,1812,353,696,.507,0,0,,353,696,.507,.507,105,137,.766,185,441,626,104,60,47,112,169,811
449,Sasha Vujacic\vujacsa01,SG,29,LAC,2,0,10,2,5,.400,1,2,.500,1,3,.333,.500,0,0,,0,3,3,0,1,0,3,1,5
450,Dwyane Wade\wadedw01,SG,32,MIA,54,53,1775,415,761,.545,9,32,.281,406,729,.557,.551,189,258,.733,60,181,241,252,79,29,161,106,1028
451,Dion Waiters\waitedi01,SG,22,CLE,70,24,2072,430,993,.433,92,250,.368,338,743,.455,.479,161,235,.685,32,163,195,209,63,17,154,153,1113
452,Kemba Walker\walkeke02,PG,23,CHA,73,73,2614,449,1143,.393,109,327,.333,340,816,.417,.441,282,337,.837,39,267,306,447,86,32,169,128,1289
453,John Wall\walljo01,PG,23,WAS,82,82,2980,579,1337,.433,108,308,.351,471,1029,.458,.473,317,394,.805,38,295,333,721,149,40,295,219,1583
454,Gerald Wallace\wallage01,SF,31,BOS,58,16,1416,116,230,.504,19,64,.297,97,166,.584,.546,47,101,.465,36,176,212,143,73,14,97,79,298
455,Casper Ware\wareca01,PG,24,PHI,9,0,116,18,42,.429,7,21,.333,11,21,.524,.512,5,6,.833,0,9,9,10,8,0,5,11,48
456,C.J. Watson\watsocj01,PG,29,IND,63,5,1193,146,334,.437,53,145,.366,93,189,.492,.516,69,88,.784,19,82,101,107,60,8,60,66,414
457,Earl Watson\watsoea01,PG,34,POR,24,0,161,3,11,.273,2,7,.286,1,4,.250,.364,4,4,1.000,5,10,15,28,5,1,17,33,12
458,Maalik Wayns\waynsma01,PG,22,LAC,2,0,9,1,2,.500,0,0,,1,2,.500,.500,0,0,,0,2,2,2,2,0,0,4,2
459,Martell Webster\webstma02,SF,27,WAS,78,13,2157,254,587,.433,146,372,.392,108,215,.502,.557,105,125,.840,38,184,222,97,41,15,58,150,759
460,David West\westda01,PF,33,IND,80,80,2472,458,939,.488,4,15,.267,454,924,.491,.490,198,251,.789,120,422,542,223,61,74,133,186,1118
461,Russell Westbrook\westbru01,PG,25,OKC,46,46,1412,346,791,.437,68,214,.318,278,577,.482,.480,242,293,.826,55,208,263,319,88,7,177,104,1002
462,D.J. White\whitedj01,PF,27,CHA,2,0,10,0,1,.000,0,0,,0,1,.000,.000,0,0,,0,2,2,0,1,0,0,1,0
463,Royce White\whitero03,PF,22,SAC,3,0,9,0,1,.000,0,0,,0,1,.000,.000,0,0,,0,0,0,0,0,0,0,2,0
464,Deron Williams\willide01,PG,29,BRK,64,58,2059,322,716,.450,98,268,.366,224,448,.500,.518,173,216,.801,15,153,168,392,93,13,143,148,915
465,Derrick Williams\willide02,SF-PF,22,TOT,78,15,1820,206,482,.427,26,99,.263,180,383,.470,.454,186,259,.718,71,252,323,56,48,20,76,114,624
465,Derrick Williams\willide02,PF,22,MIN,11,0,162,19,54,.352,2,15,.133,17,39,.436,.370,14,16,.875,3,23,26,1,4,4,6,9,54
465,Derrick Williams\willide02,SF,22,SAC,67,15,1658,187,428,.437,24,84,.286,163,344,.474,.465,172,243,.708,68,229,297,55,44,16,70,105,570
466,Elliot Williams\williel01,SG,24,PHI,67,2,1157,140,337,.415,37,125,.296,103,212,.486,.470,87,119,.731,30,100,130,72,35,3,68,126,404
467,Lou Williams\willilo02,PG,27,ATL,60,7,1445,197,493,.400,79,231,.342,118,262,.450,.480,152,179,.849,10,114,124,210,45,4,92,65,625
468,Marvin Williams\willima02,PF,27,UTA,66,50,1674,231,526,.439,84,234,.359,147,292,.503,.519,57,73,.781,82,252,334,78,54,31,53,151,603
469,Mo Williams\willima01,PG,31,POR,74,0,1834,280,672,.417,83,225,.369,197,447,.441,.478,78,89,.876,42,111,153,321,55,10,149,197,721
470,Reggie Williams\willire02,SF,27,OKC,3,0,17,5,9,.556,1,3,.333,4,6,.667,.611,0,0,,0,0,0,1,1,0,2,1,11
471,Shawne Williams\willish03,PF,27,LAL,36,13,751,73,192,.380,42,129,.326,31,63,.492,.490,14,20,.700,25,142,167,30,19,30,21,93,202
472,Jeff Withey\witheje01,C,23,NOP,58,4,684,69,129,.535,0,1,.000,69,128,.539,.535,52,73,.712,49,101,150,26,15,50,20,73,190
473,Nate Wolters\woltena01,PG,22,MIL,58,31,1309,170,389,.437,18,62,.290,152,327,.465,.460,59,90,.656,33,116,149,187,35,15,57,67,417
474,Metta World Peace\artesro01,SF,34,NYK,29,1,388,56,141,.397,17,54,.315,39,87,.448,.457,10,16,.625,18,41,59,17,24,8,19,44,139
475,Brandan Wright\wrighbr03,C,26,DAL,58,0,1077,224,331,.677,0,0,,224,331,.677,.677,77,106,.726,102,142,244,31,32,55,35,94,525
476,Chris Wright\wrighch01,SF,25,MIL,8,0,126,21,35,.600,0,1,.000,21,34,.618,.600,6,15,.400,10,10,20,5,7,5,5,17,48
477,Dorell Wright\wrighdo01,SF,28,POR,68,13,984,111,297,.374,69,202,.342,42,95,.442,.490,52,69,.754,29,162,191,64,23,16,39,62,343
478,Tony Wroten\wroteto01,PG,20,PHI,72,16,1765,345,808,.427,40,188,.213,305,620,.492,.452,209,326,.641,69,159,228,217,78,16,204,151,939
479,Nick Young\youngni01,SG,28,LAL,64,9,1810,387,889,.435,135,350,.386,252,539,.468,.511,235,285,.825,29,137,166,95,46,12,95,156,1144
480,Thaddeus Young\youngth01,PF,25,PHI,79,78,2718,582,1283,.454,90,292,.308,492,991,.496,.489,163,229,.712,166,310,476,182,167,36,165,213,1417
481,Cody Zeller\zelleco01,C,21,CHA,82,3,1416,172,404,.426,0,1,.000,172,403,.427,.426,146,200,.730,118,235,353,92,40,41,87,170,490
482,Tyler Zeller\zellety01,C,24,CLE,70,9,1049,156,290,.538,0,1,.000,156,289,.540,.538,87,121,.719,103,179,282,36,18,38,60,137,399
