Rk,Player,Pos,Age,Tm,G,GS,MP,FG,FGA,FG%,3P,3PA,3P%,2P,2PA,2P%,eFG%,FT,FTA,FT%,ORB,DRB,TRB,AST,STL,BLK,TOV,PF,PTS
1,Alex Abrines\abrinal01,SG,24,OKC,75,8,1134,115,291,.395,84,221,.380,31,70,.443,.540,39,46,.848,26,88,114,28,38,8,25,124,353
2,Quincy Acy\acyqu01,PF,27,BRK,70,8,1359,130,365,.356,102,292,.349,28,73,.384,.496,49,60,.817,40,217,257,57,33,29,60,149,411
3,Steven Adams\adamsst01,C,24,OKC,76,76,2487,448,712,.629,0,2,.000,448,710,.631,.629,160,286,.559,384,301,685,88,92,78,128,215,1056
4,Bam Adebayo\adebaba01,C,20,MIA,69,19,1368,174,340,.512,0,7,.000,174,333,.523,.512,129,179,.721,118,263,381,101,32,41,66,138,477
5,Arron Afflalo\afflaar01,SG,32,ORL,53,3,682,65,162,.401,27,70,.386,38,92,.413,.485,22,26,.846,4,62,66,30,4,9,21,56,179
6,Cole Aldrich\aldrico01,C,29,MIN,21,0,49,5,15,.333,0,0,,5,15,.333,.333,2,6,.333,3,12,15,3,2,1,1,11,12
7,LaMarcus Aldridge\aldrila01,C,32,SAS,75,75,2509,687,1347,.510,27,92,.293,660,1255,.526,.520,334,399,.837,246,389,635,152,43,90,111,161,1735
8,Jarrett Allen\allenja01,C,19,BRK,72,31,1441,234,397,.589,5,15,.333,229,382,.599,.596,114,147,.776,144,244,388,49,28,88,82,147,587
9,Kadeem Allen\allenka01,PG,25,BOS,18,1,107,6,22,.273,0,11,.000,6,11,.545,.273,7,9,.778,4,7,11,12,3,2,9,15,19
10,Tony Allen\allento01,SF,36,NOP,22,0,273,44,91,.484,4,12,.333,40,79,.506,.505,11,21,.524,20,27,47,9,11,3,19,49,103
11,Al-Farouq Aminu\aminual01,PF,27,POR,69,67,2072,230,582,.395,125,339,.369,105,243,.432,.503,59,80,.738,97,428,525,84,79,40,79,136,644
12,Justin Anderson\anderju01,SF,24,PHI,38,0,519,87,202,.431,34,103,.330,53,99,.535,.515,28,38,.737,25,68,93,25,15,7,16,54,236
13,Kyle Anderson\anderky01,SF,24,SAS,74,67,1978,231,438,.527,19,57,.333,212,381,.556,.549,104,146,.712,84,312,396,202,115,60,94,114,585
14,Ryan Anderson\anderry01,PF,29,HOU,66,50,1725,207,480,.431,131,339,.386,76,141,.539,.568,72,93,.774,94,237,331,60,24,21,42,126,617
15,Ike Anigbogu\anigbik01,C,19,IND,11,0,30,4,9,.444,0,0,,4,9,.444,.444,5,6,.833,5,4,9,0,1,3,2,1,13
16,Giannis Antetokounmpo\antetgi01,PF,23,MIL,75,75,2756,742,1402,.529,43,140,.307,699,1262,.554,.545,487,641,.760,156,597,753,361,109,106,223,231,2014
17,Carmelo Anthony\anthoca01,PF,33,OKC,78,78,2501,472,1168,.404,169,474,.357,303,694,.437,.476,148,193,.767,67,386,453,103,47,49,99,197,1261
18,OG Anunoby\anunoog01,SF,20,TOR,74,62,1481,163,346,.471,73,197,.371,90,149,.604,.577,39,62,.629,44,140,184,55,52,14,45,130,438
19,Ryan Arcidiacono\arcidry01,PG,23,CHI,24,0,304,17,41,.415,9,31,.290,8,10,.800,.524,5,6,.833,1,24,25,35,13,0,13,18,48
20,Trevor Ariza\arizatr01,SF,32,HOU,67,67,2269,268,651,.412,170,462,.368,98,189,.519,.542,76,89,.854,33,261,294,105,98,13,52,132,782
21,Darrell Arthur\arthuda01,PF,29,DEN,19,1,141,22,47,.468,8,23,.348,14,24,.583,.553,2,3,.667,3,12,15,9,8,3,15,22,54
22,Jamel Artis\artisja01,SG,25,ORL,15,1,279,31,79,.392,8,29,.276,23,50,.460,.443,7,12,.583,4,34,38,18,2,3,8,11,77
23,Omer Asik\asikom01,C,31,TOT,18,0,182,9,22,.409,0,0,,9,22,.409,.409,4,13,.308,9,38,47,3,2,4,9,20,22
23,Omer Asik\asikom01,C,31,NOP,14,0,121,7,16,.438,0,0,,7,16,.438,.438,4,12,.333,7,30,37,2,1,2,5,14,18
23,Omer Asik\asikom01,C,31,CHI,4,0,61,2,6,.333,0,0,,2,6,.333,.333,0,1,.000,2,8,10,1,1,2,4,6,4
24,D.J. Augustin\augusdj01,PG,30,ORL,75,36,1760,244,540,.452,114,272,.419,130,268,.485,.557,164,189,.868,30,130,160,287,54,0,123,94,766
25,Luke Babbitt\babbilu01,SF,28,TOT,50,14,715,91,215,.423,60,156,.385,31,59,.525,.563,17,22,.773,7,89,96,31,8,7,19,54,259
25,Luke Babbitt\babbilu01,SF,28,ATL,37,9,570,80,168,.476,49,111,.441,31,57,.544,.622,17,22,.773,5,76,81,26,7,5,15,47,226
25,Luke Babbitt\babbilu01,SF,28,MIA,13,5,145,11,47,.234,11,45,.244,0,2,.000,.351,0,0,,2,13,15,5,1,2,4,7,33
26,Dwayne Bacon\bacondw01,SG,22,CHO,53,6,713,72,192,.375,11,43,.256,61,149,.409,.404,20,25,.800,4,120,124,38,16,2,23,46,175
27,Ron Baker\bakerro01,SG,24,NYK,29,1,385,20,59,.339,11,33,.333,9,26,.346,.432,20,26,.769,5,25,30,47,26,6,18,33,71
28,Wade Baldwin\baldwwa01,PG,21,POR,7,0,80,14,21,.667,4,5,.800,10,16,.625,.762,6,10,.600,1,7,8,5,2,1,4,12,38
29,Lonzo Ball\balllo01,PG,20,LAL,52,50,1780,203,564,.360,90,295,.305,113,269,.420,.440,32,71,.451,69,291,360,376,88,43,136,117,528
30,J.J. Barea\bareajo01,PG,33,DAL,69,10,1603,303,690,.439,115,313,.367,188,377,.499,.522,80,102,.784,15,186,201,434,35,3,143,83,801
31,Harrison Barnes\barneha02,PF,25,DAL,77,77,2634,537,1208,.445,119,333,.357,418,875,.478,.494,259,313,.827,77,391,468,152,49,14,118,94,1452
32,Will Barton\bartowi01,SG,27,DEN,81,40,2683,465,1028,.452,156,422,.370,309,606,.510,.528,182,226,.805,70,339,409,331,82,52,149,168,1268
33,Nicolas Batum\batumni01,SG,29,CHO,64,64,1981,270,650,.415,92,274,.336,178,376,.473,.486,108,130,.831,57,249,306,349,65,23,131,72,740
34,Jerryd Bayless\bayleje01,SG,29,PHI,39,11,925,109,262,.416,54,146,.370,55,116,.474,.519,35,44,.795,15,65,80,54,23,6,46,91,307
35,Aron Baynes\baynear01,C,31,BOS,81,67,1485,210,446,.471,3,21,.143,207,425,.487,.474,59,78,.756,130,304,434,93,22,51,80,200,482
36,Kent Bazemore\bazemke01,SG,28,ATL,65,65,1789,284,676,.420,108,274,.394,176,402,.438,.500,160,201,.796,25,223,248,228,100,45,157,147,836
37,Bradley Beal\bealbr01,SG,24,WAS,82,82,2977,683,1484,.460,199,530,.375,484,954,.507,.527,292,369,.791,61,302,363,373,96,36,214,160,1857
38,Malik Beasley\beaslma01,SG,21,DEN,62,0,583,73,178,.410,28,82,.341,45,96,.469,.489,22,33,.667,14,57,71,31,15,7,24,36,196
39,Michael Beasley\beaslmi01,PF,29,NYK,74,30,1653,409,807,.507,34,86,.395,375,721,.520,.528,124,159,.780,97,317,414,123,36,43,143,145,976
40,Marco Belinelli\belinma01,SG,31,TOT,80,2,1947,337,764,.441,149,395,.377,188,369,.509,.539,148,163,.908,20,131,151,148,66,12,94,91,971
40,Marco Belinelli\belinma01,SG,31,ATL,52,1,1210,199,485,.410,92,247,.372,107,238,.450,.505,101,109,.927,14,86,100,103,46,3,54,41,591
40,Marco Belinelli\belinma01,SG,31,PHI,28,1,737,138,279,.495,57,148,.385,81,131,.618,.597,47,54,.870,6,45,51,45,20,9,40,50,380
41,Jordan Bell\belljo01,C,23,GSW,57,13,809,116,185,.627,0,4,.000,116,181,.641,.627,30,44,.682,60,147,207,102,35,56,51,92,262
42,DeAndre' Bembry\bembrde01,SF,23,ATL,26,3,455,53,128,.414,11,30,.367,42,98,.429,.457,19,33,.576,8,64,72,49,21,12,47,38,136
43,Dragan Bender\bendedr01,PF,20,PHO,82,37,2069,187,484,.386,118,322,.366,69,162,.426,.508,39,51,.765,40,321,361,130,22,53,112,166,531
44,Davis Bertans\bertada01,PF,25,SAS,77,10,1086,161,366,.440,94,252,.373,67,114,.588,.568,40,49,.816,18,135,153,74,26,28,36,93,456
45,Patrick Beverley\beverpa01,SG,29,LAC,11,11,334,48,119,.403,24,60,.400,24,59,.407,.504,14,17,.824,16,29,45,32,19,5,25,34,134
46,Khem Birch\birchkh01,C,25,ORL,42,0,578,68,126,.540,0,0,,68,126,.540,.540,42,61,.689,70,110,180,34,15,21,21,56,178
47,Jabari Bird\birdja01,SG,23,BOS,13,1,115,15,26,.577,3,7,.429,12,19,.632,.635,6,13,.462,6,13,19,8,3,1,8,7,39
48,Bismack Biyombo\biyombi01,C,25,ORL,82,25,1495,183,352,.520,0,1,.000,183,351,.521,.520,102,157,.650,144,324,468,66,21,95,84,158,468
49,Nemanja Bjelica\bjeline01,PF,29,MIN,67,21,1371,171,371,.461,76,183,.415,95,188,.505,.563,36,45,.800,53,221,274,86,50,16,52,141,454
50,Tarik Black\blackta01,C,26,HOU,51,2,536,75,127,.591,1,11,.091,74,116,.638,.594,29,63,.460,63,100,163,13,21,30,35,107,180
51,Antonio Blakeney\blakean01,SG,21,CHI,19,0,314,53,143,.371,15,52,.288,38,91,.418,.423,30,39,.769,4,29,33,20,7,1,11,19,151
52,Eric Bledsoe\bledser01,PG,28,TOT,74,74,2322,468,989,.473,125,360,.347,343,629,.545,.536,252,317,.795,51,233,284,370,149,42,216,185,1313
52,Eric Bledsoe\bledser01,PG,28,PHO,3,3,83,16,40,.400,4,13,.308,12,27,.444,.450,11,14,.786,3,4,7,9,4,2,10,6,47
52,Eric Bledsoe\bledser01,PG,28,MIL,71,71,2239,452,949,.476,121,347,.349,331,602,.550,.540,241,303,.795,48,229,277,361,145,40,206,179,1266
53,Vander Blue\blueva01,SG,25,LAL,5,0,45,1,5,.200,0,2,.000,1,3,.333,.200,1,2,.500,0,1,1,3,1,0,3,2,3
54,Bogdan Bogdanovic\bogdabo01,SG,25,SAC,78,53,2175,344,772,.446,129,329,.392,215,443,.485,.529,100,119,.840,31,192,223,258,72,16,125,172,917
55,Bojan Bogdanovic\bogdabo02,SF,28,IND,80,80,2464,404,852,.474,155,386,.402,249,466,.534,.565,178,205,.868,30,240,270,119,55,8,106,129,1141
56,Andrew Bogut\bogutan01,C,33,LAL,23,5,216,17,25,.680,0,0,,17,25,.680,.680,2,2,1.000,26,52,78,15,4,13,19,40,36
57,Joel Bolomboy\bolomjo01,PF,24,MIL,6,0,38,3,6,.500,0,1,.000,3,5,.600,.500,3,6,.500,6,4,10,0,2,0,2,3,9
58,Devin Booker\bookede01,SG,21,PHO,54,54,1865,455,1054,.432,147,384,.383,308,670,.460,.501,289,329,.878,26,218,244,253,47,14,194,168,1346
59,Trevor Booker\booketr01,PF,30,TOT,68,7,1158,177,343,.516,8,33,.242,169,310,.545,.528,66,93,.710,117,201,318,82,28,21,59,119,428
59,Trevor Booker\booketr01,PF,30,BRK,18,6,395,77,150,.513,3,12,.250,74,138,.536,.523,24,43,.558,38,81,119,38,8,5,30,43,181
59,Trevor Booker\booketr01,PF,30,PHI,33,0,494,61,109,.560,2,7,.286,59,102,.578,.569,32,39,.821,47,75,122,27,16,11,20,50,156
59,Trevor Booker\booketr01,PF,30,IND,17,1,269,39,84,.464,3,14,.214,36,70,.514,.482,10,11,.909,32,45,77,17,4,5,9,26,91
60,Chris Boucher\bouchch01,PF,25,GSW,1,0,1,0,1,.000,0,1,.000,0,0,,.000,0,0,,0,1,1,0,0,0,0,0,0
61,Avery Bradley\bradlav01,SG,27,TOT,46,46,1433,259,625,.414,75,203,.369,184,422,.436,.474,63,82,.768,22,94,116,94,51,8,101,92,656
61,Avery Bradley\bradlav01,SG,27,DET,40,40,1268,233,570,.409,74,194,.381,159,376,.423,.474,61,80,.763,19,75,94,83,46,7,93,80,601
61,Avery Bradley\bradlav01,SG,27,LAC,6,6,165,26,55,.473,1,9,.111,25,46,.543,.482,2,2,1.000,3,19,22,11,5,1,8,12,55
62,Tony Bradley\bradlto01,C,20,UTA,9,0,29,3,11,.273,0,1,.000,3,10,.300,.273,2,2,1.000,4,7,11,1,0,0,0,1,8
63,Corey Brewer\breweco01,SF-SG,31,TOT,72,18,1208,142,316,.449,31,110,.282,111,206,.539,.498,65,90,.722,43,111,154,65,79,14,49,139,380
63,Corey Brewer\breweco01,SF,31,LAL,54,2,694,78,172,.453,8,43,.186,70,129,.543,.477,34,51,.667,23,70,93,41,41,8,38,83,198
63,Corey Brewer\breweco01,SG,31,OKC,18,16,514,64,144,.444,23,67,.343,41,77,.532,.524,31,39,.795,20,41,61,24,38,6,11,56,182
64,Malcolm Brogdon\brogdma01,PG,25,MIL,48,20,1436,244,503,.485,62,161,.385,182,342,.532,.547,75,85,.882,23,133,156,152,41,13,66,128,625
65,Aaron Brooks\brookaa01,PG,33,MIN,32,1,189,28,69,.406,11,31,.355,17,38,.447,.486,8,11,.727,7,10,17,20,6,0,11,28,75
66,Dillon Brooks\brookdi01,SF,22,MEM,82,74,2350,340,772,.440,94,264,.356,246,508,.484,.501,124,166,.747,49,208,257,135,73,17,124,233,898
67,MarShon Brooks\brookma01,SG,29,MEM,7,1,193,51,102,.500,19,32,.594,32,70,.457,.593,20,23,.870,8,13,21,25,11,3,16,6,141
68,Anthony Brown\brownan02,SF,25,MIN,1,0,4,1,1,1.000,1,1,1.000,0,0,,1.500,0,0,,0,0,0,1,0,0,0,0,3
69,Bobby Brown\brownbo02,PG,33,HOU,20,0,115,19,58,.328,11,40,.275,8,18,.444,.422,1,2,.500,0,7,7,11,4,0,9,6,50
70,Jaylen Brown\brownja02,SG,21,BOS,70,70,2152,373,803,.465,121,306,.395,252,497,.507,.540,150,233,.644,66,280,346,114,70,26,124,181,1017
71,Lorenzo Brown\brownlo01,PG,27,TOR,14,0,139,14,34,.412,2,12,.167,12,22,.545,.441,2,2,1.000,1,14,15,13,5,0,3,7,32
72,Markel Brown\brownma02,SG,26,HOU,4,0,31,2,7,.286,1,5,.200,1,2,.500,.357,0,0,,1,4,5,2,0,0,2,6,5
73,Sterling Brown\brownst02,SG,22,MIL,54,4,776,82,205,.400,32,91,.352,50,114,.439,.478,21,24,.875,27,116,143,25,31,13,25,80,217
74,Nicolas Brussino\brussni01,SF,24,ATL,4,0,10,0,2,.000,0,2,.000,0,0,,.000,0,0,,0,3,3,0,0,0,0,0,0
75,Thomas Bryant\bryanth01,C,20,LAL,15,0,72,8,21,.381,1,10,.100,7,11,.636,.405,5,9,.556,3,14,17,6,1,2,2,6,22
76,Reggie Bullock\bullore01,SF,26,DET,62,52,1732,267,546,.489,125,281,.445,142,265,.536,.603,39,49,.796,27,127,154,95,47,13,47,70,698
77,Trey Burke\burketr01,PG,25,NYK,36,9,785,193,384,.503,38,105,.362,155,279,.556,.552,37,57,.649,13,58,71,170,24,4,43,43,461
78,Alec Burks\burksal01,SG,26,UTA,64,1,1059,170,414,.411,47,142,.331,123,272,.452,.467,107,124,.863,19,173,192,67,37,8,60,75,494
79,Jimmy Butler\butleji01,SG,28,MIN,59,59,2164,437,921,.474,70,200,.350,367,721,.509,.512,363,425,.854,79,235,314,288,116,24,108,78,1307
80,Dwight Buycks\buyckdw01,PG,28,DET,29,0,427,82,198,.414,15,45,.333,67,153,.438,.452,36,41,.878,12,29,41,59,19,2,39,39,215
81,Bruno Caboclo\cabocbr01,SF,22,TOT,12,0,107,9,31,.290,3,17,.176,6,14,.429,.339,5,6,.833,7,15,22,4,3,4,4,8,26
81,Bruno Caboclo\cabocbr01,SF,22,TOR,2,0,7,0,2,.000,0,2,.000,0,0,,.000,0,0,,0,1,1,1,1,0,0,1,0
81,Bruno Caboclo\cabocbr01,SF,22,SAC,10,0,100,9,29,.310,3,15,.200,6,14,.429,.362,5,6,.833,7,14,21,3,2,4,4,7,26
82,Jose Calderon\caldejo01,PG,36,CLE,57,32,914,93,185,.503,45,97,.464,48,88,.545,.624,24,30,.800,14,70,84,117,27,2,41,81,255
83,Kentavious Caldwell-Pope\caldwke01,SG,24,LAL,74,74,2458,340,798,.426,159,415,.383,181,383,.473,.526,153,194,.789,60,327,387,162,106,16,97,145,992
84,Isaiah Canaan\canaais01,PG-SG,26,TOT,20,1,422,52,137,.380,22,66,.333,30,71,.423,.460,46,51,.902,6,39,45,76,16,1,29,36,172
84,Isaiah Canaan\canaais01,SG,26,HOU,1,0,4,0,1,.000,0,0,,0,1,.000,.000,0,0,,0,1,1,0,0,0,0,0,0
84,Isaiah Canaan\canaais01,PG,26,PHO,19,1,418,52,136,.382,22,66,.333,30,70,.429,.463,46,51,.902,6,38,44,76,16,1,29,36,172
85,Clint Capela\capelca01,C,23,HOU,74,74,2034,441,676,.652,0,1,.000,441,675,.653,.652,144,257,.560,241,561,802,68,58,137,103,185,1026
86,DeMarre Carroll\carrode01,SF,31,BRK,73,73,2180,325,785,.414,145,391,.371,180,394,.457,.506,188,246,.764,105,374,479,147,59,30,103,165,983
87,Vince Carter\cartevi01,SF,41,SAC,58,5,1026,114,283,.403,57,165,.345,57,118,.483,.504,28,37,.757,18,130,148,69,42,26,36,96,313
88,Michael Carter-Williams\cartemi01,PG,26,CHO,52,2,835,76,229,.332,14,59,.237,62,170,.365,.362,73,89,.820,37,101,138,116,44,23,52,99,239
89,Alex Caruso\carusal01,PG,23,LAL,37,7,562,50,116,.431,13,43,.302,37,73,.507,.487,21,30,.700,15,50,65,75,23,10,42,52,134
90,Omri Casspi\casspom01,SF,29,GSW,53,7,740,120,207,.580,10,22,.455,110,185,.595,.604,50,69,.725,30,170,200,51,18,19,37,71,300
91,Willie Cauley-Stein\caulewi01,C,24,SAC,73,58,2044,388,773,.502,3,12,.250,385,761,.506,.504,153,247,.619,131,379,510,172,77,67,109,185,932
92,Tyler Cavanaugh\cavanty01,PF,23,ATL,39,1,518,67,152,.441,32,89,.360,35,63,.556,.546,17,21,.810,45,82,127,27,9,4,14,61,183
93,Mario Chalmers\chalmma01,PG,31,MEM,66,10,1421,168,443,.379,53,191,.277,115,252,.456,.439,118,138,.855,13,144,157,197,79,14,117,179,507
94,Tyson Chandler\chandty01,C,35,PHO,46,46,1151,121,187,.647,0,0,,121,187,.647,.647,58,93,.624,134,284,418,53,16,27,59,106,300
95,Wilson Chandler\chandwi01,SF,30,DEN,74,71,2346,281,631,.445,88,246,.358,193,385,.501,.515,88,114,.772,102,296,398,159,43,39,92,156,738
96,Marquese Chriss\chrisma01,PF,20,PHO,72,49,1527,202,477,.423,56,190,.295,146,287,.509,.482,96,158,.608,76,319,395,83,51,70,107,205,556
97,Ian Clark\clarkia01,SG,26,NOP,74,2,1455,222,495,.448,62,195,.318,160,300,.533,.511,45,59,.763,10,117,127,110,33,10,57,120,551
98,Jordan Clarkson\clarkjo01,SG,25,TOT,81,2,1888,430,954,.451,112,318,.352,318,636,.500,.509,152,190,.800,57,160,217,221,58,6,127,107,1124
98,Jordan Clarkson\clarkjo01,SG,25,LAL,53,2,1256,299,667,.448,68,210,.324,231,457,.505,.499,105,132,.795,44,115,159,173,39,3,95,63,771
98,Jordan Clarkson\clarkjo01,SG,25,CLE,28,0,632,131,287,.456,44,108,.407,87,179,.486,.533,47,58,.810,13,45,58,48,19,3,32,44,353
99,Gian Clavell\clavegi01,SG,24,DAL,7,0,64,6,18,.333,6,15,.400,0,3,.000,.500,2,2,1.000,1,6,7,3,2,0,2,8,20
100,Antonius Cleveland\clevean01,SG,23,TOT,17,0,123,8,21,.381,3,4,.750,5,17,.294,.452,4,6,.667,3,11,14,2,7,5,7,23,23
100,Antonius Cleveland\clevean01,SG,23,DAL,13,0,81,4,14,.286,0,1,.000,4,13,.308,.286,2,4,.500,2,8,10,2,6,4,2,11,10
100,Antonius Cleveland\clevean01,SG,23,ATL,4,0,42,4,7,.571,3,3,1.000,1,4,.250,.786,2,2,1.000,1,3,4,0,1,1,5,12,13
101,John Collins\collijo01,PF,20,ATL,74,26,1785,314,545,.576,16,47,.340,298,498,.598,.591,133,186,.715,176,365,541,98,47,80,105,215,777
102,Zach Collins\colliza01,C,20,POR,66,1,1045,115,289,.398,35,113,.310,80,176,.455,.458,27,42,.643,45,176,221,52,17,31,58,133,292
103,Kyle Collinsworth\colliky01,SF,26,DAL,32,2,480,38,99,.384,4,17,.235,34,82,.415,.404,21,40,.525,32,75,107,56,17,9,24,44,101
104,Darren Collison\collida01,PG,30,IND,69,64,2018,316,638,.495,96,205,.468,220,433,.508,.571,127,144,.882,37,141,178,368,92,15,86,122,855
105,Nick Collison\collini01,PF,37,OKC,15,0,75,13,19,.684,0,0,,13,19,.684,.684,5,13,.385,7,13,20,4,0,0,7,7,31
106,Mike Conley\conlemi01,PG,30,MEM,12,12,373,64,168,.381,24,77,.312,40,91,.440,.452,53,66,.803,0,27,27,49,12,3,18,24,205
107,Pat Connaughton\connapa01,SG,25,POR,82,5,1488,165,390,.423,74,210,.352,91,180,.506,.518,37,44,.841,36,125,161,91,23,22,43,120,441
108,Quinn Cook\cookqu01,PG,24,GSW,33,18,740,122,252,.484,46,104,.442,76,148,.514,.575,22,25,.880,10,72,82,89,12,1,32,59,312
109,Charles Cooke\cookech01,SG,23,NOP,13,0,38,2,14,.143,1,8,.125,1,6,.167,.179,1,2,.500,0,2,2,1,1,0,1,0,6
110,Jack Cooley\cooleja01,PF,26,SAC,7,0,87,13,27,.481,0,0,,13,27,.481,.481,14,19,.737,14,16,30,6,1,0,3,13,40
111,Matt Costello\costema01,C,24,SAS,4,0,32,2,4,.500,0,0,,2,4,.500,.500,0,0,,1,8,9,2,2,2,1,7,4
112,DeMarcus Cousins\couside01,C,27,NOP,48,48,1737,406,864,.470,104,294,.354,302,570,.530,.530,294,394,.746,105,512,617,257,79,76,242,183,1210
113,Robert Covington\covinro01,SF,27,PHI,80,80,2532,345,836,.413,203,550,.369,142,286,.497,.534,116,136,.853,55,378,433,156,137,72,126,238,1009
114,Allen Crabbe\crabbal01,SG,25,BRK,75,68,2197,337,827,.407,201,532,.378,136,295,.461,.529,115,135,.852,28,296,324,117,47,35,78,168,990
115,Torrey Craig\craigto01,SF,27,DEN,39,5,629,62,137,.453,17,58,.293,45,79,.570,.515,22,35,.629,40,87,127,25,12,15,20,63,163
116,Jamal Crawford\crawfja01,SG,37,MIN,80,0,1653,308,742,.415,104,314,.331,204,428,.477,.485,102,113,.903,21,78,99,185,40,9,95,85,822
117,Jordan Crawford\crawfjo02,SG,29,NOP,5,0,53,12,27,.444,8,14,.571,4,13,.308,.593,1,1,1.000,2,2,4,13,1,1,5,7,33
118,Jae Crowder\crowdja01,SF,27,TOT,80,47,2090,271,671,.404,110,341,.323,161,330,.488,.486,121,148,.818,59,216,275,99,64,21,74,187,773
118,Jae Crowder\crowdja01,SF,27,CLE,53,47,1346,157,376,.418,62,189,.328,95,187,.508,.500,78,92,.848,41,132,173,58,41,12,42,124,454
118,Jae Crowder\crowdja01,SF,27,UTA,27,0,744,114,295,.386,48,152,.316,66,143,.462,.468,43,56,.768,18,84,102,41,23,9,32,63,319
119,Dante Cunningham\cunnida01,SF,30,TOT,73,25,1562,164,364,.451,58,168,.345,106,196,.541,.530,31,52,.596,78,220,298,48,39,30,33,111,417
119,Dante Cunningham\cunnida01,SF,30,NOP,51,24,1115,99,225,.440,35,108,.324,64,117,.547,.518,20,36,.556,50,143,193,26,27,16,16,75,253
119,Dante Cunningham\cunnida01,SF,30,BRK,22,1,447,65,139,.468,23,60,.383,42,79,.532,.550,11,16,.688,28,77,105,22,12,14,17,36,164
120,Stephen Curry\curryst01,PG,29,GSW,51,51,1631,428,864,.495,212,501,.423,216,363,.595,.618,278,302,.921,36,225,261,310,80,8,153,114,1346
121,Troy Daniels\danietr01,SG,26,PHO,79,15,1622,232,575,.403,183,458,.400,49,117,.419,.563,56,64,.875,12,115,127,48,26,5,56,137,703
122,Anthony Davis\davisan02,PF,24,NOP,75,75,2727,780,1462,.534,55,162,.340,725,1300,.558,.552,495,598,.828,187,645,832,174,115,193,162,159,2110
123,Deyonta Davis\davisde01,C,21,MEM,62,6,943,161,265,.608,0,0,,161,265,.608,.608,38,57,.667,75,175,250,40,15,39,32,125,360
124,Ed Davis\davised01,C,28,POR,78,0,1471,170,292,.582,0,1,.000,170,291,.584,.582,74,111,.667,183,392,575,40,32,52,66,188,414
125,Dewayne Dedmon\dedmode01,C,28,ATL,62,46,1542,250,477,.524,50,141,.355,200,336,.595,.577,67,86,.779,100,389,489,90,40,51,86,162,617
126,Sam Dekker\dekkesa01,PF,23,LAC,73,1,883,128,259,.494,10,60,.167,118,199,.593,.514,37,56,.661,44,130,174,38,24,9,33,71,303
127,Malcolm Delaney\delanma01,PG,28,ATL,54,3,1014,109,285,.382,46,124,.371,63,161,.391,.463,74,92,.804,9,91,100,163,35,6,66,82,338
128,Matthew Dellavedova\dellama01,PG,27,MIL,38,3,712,55,152,.362,29,78,.372,26,74,.351,.457,25,27,.926,14,50,64,145,14,0,49,67,164
129,Luol Deng\denglu01,SF,32,LAL,1,1,13,1,2,.500,0,0,,1,2,.500,.500,0,0,,0,0,0,1,1,0,1,0,2
130,DeMar DeRozan\derozde01,SG,28,TOR,80,80,2711,645,1413,.456,89,287,.310,556,1126,.494,.488,461,559,.825,59,256,315,417,85,22,175,151,1840
131,Cheick Diallo\diallch01,PF,21,NOP,52,0,581,102,176,.580,0,0,,102,176,.580,.580,50,66,.758,47,164,211,19,11,21,28,82,254
132,Gorgui Dieng\dienggo01,C,28,MIN,79,0,1333,186,388,.479,19,61,.311,167,327,.511,.504,79,102,.775,106,254,360,71,45,39,59,147,470
133,Spencer Dinwiddie\dinwisp01,PG,24,BRK,80,58,2306,324,838,.387,141,433,.326,183,405,.452,.471,218,268,.813,40,219,259,524,68,23,128,186,1007
134,Tyler Dorsey\dorsety01,SG,21,ATL,56,5,974,144,382,.377,72,199,.362,72,183,.393,.471,45,63,.714,17,113,130,79,17,5,37,63,405
135,Damyean Dotson\dotsoda01,SG,23,NYK,44,2,474,72,161,.447,22,68,.324,50,93,.538,.516,16,23,.696,9,75,84,31,12,2,17,34,182
136,Milton Doyle\doylemi01,SG,24,BRK,10,0,125,13,47,.277,4,23,.174,9,24,.375,.319,4,8,.500,3,15,18,10,6,2,2,13,34
137,PJ Dozier\doziepj01,PG,21,OKC,2,0,3,1,2,.500,0,0,,1,2,.500,.500,0,0,,0,1,1,0,0,0,1,1,2
138,Goran Dragic\dragigo01,PG,31,MIA,75,75,2378,484,1075,.450,111,300,.370,373,775,.481,.502,217,271,.801,54,253,307,359,63,12,166,180,1296
139,Larry Drew\drewla02,PG,27,TOT,10,0,70,7,24,.292,3,9,.333,4,15,.267,.354,0,0,,3,0,3,10,0,0,3,6,17
139,Larry Drew\drewla02,PG,27,PHI,3,0,15,1,7,.143,0,3,.000,1,4,.250,.143,0,0,,1,0,1,2,0,0,1,2,2
139,Larry Drew\drewla02,PG,27,NOP,7,0,55,6,17,.353,3,6,.500,3,11,.273,.441,0,0,,2,0,2,8,0,0,2,4,15
140,Andre Drummond\drumman01,C,24,DET,78,78,2625,466,881,.529,0,11,.000,466,870,.536,.529,239,395,.605,399,848,1247,237,114,127,200,250,1171
141,Jared Dudley\dudleja01,PF,32,PHO,48,0,686,48,122,.393,29,80,.363,19,42,.452,.512,27,35,.771,8,86,94,78,24,11,28,85,152
142,Kris Dunn\dunnkr01,PG,23,CHI,52,43,1525,286,666,.429,43,134,.321,243,532,.457,.462,84,114,.737,24,197,221,310,104,27,150,174,699
143,Kevin Durant\duranke01,PF,29,GSW,68,68,2325,630,1222,.516,173,413,.419,457,809,.565,.586,359,404,.889,31,433,464,366,50,119,207,133,1792
144,Jarell Eddie\eddieja01,SF,26,TOT,3,0,9,0,2,.000,0,2,.000,0,0,,.000,0,0,,0,1,1,0,1,0,0,0,0
144,Jarell Eddie\eddieja01,SF,26,BOS,2,0,6,0,1,.000,0,1,.000,0,0,,.000,0,0,,0,1,1,0,1,0,0,0,0
144,Jarell Eddie\eddieja01,SF,26,CHI,1,0,3,0,1,.000,0,1,.000,0,0,,.000,0,0,,0,0,0,0,0,0,0,0,0
145,Henry Ellenson\ellenhe01,PF,21,DET,38,0,329,53,146,.363,20,60,.333,33,86,.384,.432,25,29,.862,10,71,81,20,5,0,18,22,151
146,Wayne Ellington\ellinwa01,SG,30,MIA,77,2,2041,285,700,.407,227,579,.392,58,121,.479,.569,67,78,.859,23,195,218,79,53,8,52,94,864
147,Joel Embiid\embiijo01,C,23,PHI,63,63,1912,510,1056,.483,66,214,.308,444,842,.527,.514,359,467,.769,143,547,690,199,40,111,234,209,1445
148,James Ennis\ennisja01,SF,27,TOT,72,22,1604,182,384,.474,51,153,.333,131,231,.567,.540,97,116,.836,73,151,224,71,47,18,56,134,512
148,James Ennis\ennisja01,SF,27,MEM,45,14,1053,108,222,.486,30,84,.357,78,138,.565,.554,64,73,.877,53,104,157,49,32,12,38,81,310
148,James Ennis\ennisja01,SF,27,DET,27,8,551,74,162,.457,21,69,.304,53,93,.570,.522,33,43,.767,20,47,67,22,15,6,18,53,202
149,Tyler Ennis\ennisty01,PG,23,LAL,54,11,683,94,224,.420,14,56,.250,80,168,.476,.451,22,29,.759,19,76,95,105,30,10,38,75,224
150,Jawun Evans\evansja01,PG,21,LAC,48,4,778,89,253,.352,15,54,.278,74,199,.372,.381,38,49,.776,9,75,84,100,36,6,44,97,231
151,Jeremy Evans\evansje01,SF,30,ATL,1,0,5,1,1,1.000,0,0,,1,1,1.000,1.000,0,0,,1,0,1,0,0,0,1,1,2
152,Tyreke Evans\evansty01,PG,28,MEM,52,32,1607,366,809,.452,114,286,.399,252,523,.482,.523,164,209,.785,44,221,265,269,57,17,117,96,1010
153,Dante Exum\exumda01,PG,22,UTA,14,0,235,42,87,.483,5,18,.278,37,69,.536,.511,25,31,.806,4,22,26,43,8,3,20,20,114
154,Kenneth Faried\farieke01,PF,28,DEN,32,7,461,76,148,.514,0,1,.000,76,147,.517,.514,36,51,.706,68,85,153,18,12,13,23,51,188
155,Derrick Favors\favorde01,C,26,UTA,77,77,2153,395,702,.563,14,63,.222,381,639,.596,.573,140,215,.651,198,354,552,102,54,82,88,164,944
156,Kay Felder\feldeka01,PG,22,TOT,16,0,140,21,70,.300,4,19,.211,17,51,.333,.329,11,12,.917,3,15,18,20,3,1,16,11,57
156,Kay Felder\feldeka01,PG,22,CHI,14,0,134,20,66,.303,4,18,.222,16,48,.333,.333,11,12,.917,1,13,14,20,3,1,15,11,55
156,Kay Felder\feldeka01,PG,22,DET,2,0,6,1,4,.250,0,1,.000,1,3,.333,.250,0,0,,2,2,4,0,0,0,1,0,2
157,Cristiano Felicio\feliccr01,C,25,CHI,55,16,977,127,215,.591,0,2,.000,127,213,.596,.591,54,81,.667,83,150,233,55,16,11,54,104,308
158,Raymond Felton\feltora01,PG,33,OKC,82,2,1365,224,552,.406,81,230,.352,143,322,.444,.479,36,44,.818,25,131,156,203,49,16,76,91,565
159,Terrance Ferguson\fergute01,SG,19,OKC,61,12,763,70,169,.414,40,120,.333,30,49,.612,.533,9,10,.900,19,28,47,19,24,10,11,83,189
160,Yogi Ferrell\ferreyo01,SG,24,DAL,82,21,2282,311,730,.426,134,359,.373,177,371,.477,.518,82,103,.796,26,223,249,201,64,9,78,153,838
161,Dorian Finney-Smith\finnedo01,PF,24,DAL,21,13,448,46,121,.380,20,67,.299,26,54,.481,.463,11,15,.733,22,53,75,26,10,4,21,43,123
162,Bryn Forbes\forbebr01,SG,24,SAS,80,12,1517,209,497,.421,89,228,.390,120,269,.446,.510,48,72,.667,12,98,110,80,28,2,37,108,555
163,Evan Fournier\fournev01,SF,25,ORL,57,57,1837,368,802,.459,127,335,.379,241,467,.516,.538,150,173,.867,23,157,180,165,47,16,95,138,1013
164,De'Aaron Fox\foxde01,PG,20,SAC,73,60,2026,328,797,.412,47,153,.307,281,644,.436,.441,141,195,.723,33,171,204,320,70,20,173,163,844
165,Tim Frazier\fraziti01,PG,27,WAS,59,11,838,68,172,.395,17,56,.304,51,116,.440,.445,23,30,.767,18,97,115,194,47,7,57,97,176
166,Channing Frye\fryech01,C,34,TOT,53,1,695,104,212,.491,39,115,.339,65,97,.670,.583,17,19,.895,12,123,135,38,18,13,21,69,264
166,Channing Frye\fryech01,C,34,CLE,44,1,545,84,169,.497,30,90,.333,54,79,.684,.586,14,15,.933,10,100,110,28,17,12,17,54,212
166,Channing Frye\fryech01,C,34,LAL,9,0,150,20,43,.465,9,25,.360,11,18,.611,.570,3,4,.750,2,23,25,10,1,1,4,15,52
167,Markelle Fultz\fultzma01,SG,19,PHI,14,0,253,45,111,.405,0,1,.000,45,110,.409,.405,10,21,.476,11,32,43,53,12,4,17,22,100
168,Danilo Gallinari\gallida01,SF,29,LAC,21,21,671,102,256,.398,36,111,.324,66,145,.455,.469,81,87,.931,9,92,101,41,12,10,26,30,321
169,Langston Galloway\gallola01,SG,26,DET,58,2,863,126,340,.371,75,218,.344,51,122,.418,.481,33,41,.805,13,79,92,58,35,5,18,39,360
170,Marc Gasol\gasolma01,C,33,MEM,73,73,2408,434,1033,.420,109,320,.341,325,713,.456,.473,281,337,.834,78,514,592,305,54,101,194,185,1258
171,Pau Gasol\gasolpa01,C,37,SAS,77,63,1812,287,627,.458,43,120,.358,244,507,.481,.492,158,209,.756,129,490,619,238,24,79,108,121,775
172,Rudy Gay\gayru01,PF,31,SAS,57,6,1231,253,537,.471,37,118,.314,216,419,.516,.506,112,145,.772,76,215,291,73,46,38,78,98,655
173,Paul George\georgpa01,SF,27,OKC,79,79,2891,576,1340,.430,244,609,.401,332,731,.454,.521,338,411,.822,72,375,447,263,161,39,212,233,1734
174,Marcus Georges-Hunt\georgma01,SG,23,MIN,42,0,224,21,48,.438,4,15,.267,17,33,.515,.479,13,21,.619,7,9,16,7,6,0,3,32,59
175,Jonathan Gibson\gibsojo01,PG,30,BOS,4,0,40,14,23,.609,6,12,.500,8,11,.727,.739,0,0,,0,3,3,4,0,0,3,5,34
176,Taj Gibson\gibsota01,PF,32,MIN,82,82,2726,425,737,.577,7,35,.200,418,702,.595,.581,142,185,.768,194,390,584,99,62,59,89,218,999
177,Manu Ginobili\ginobma01,SG,40,SAS,65,0,1299,201,463,.434,64,192,.333,137,271,.506,.503,110,131,.840,19,123,142,163,43,16,105,126,576
178,Rudy Gobert\goberru01,C,25,UTA,56,56,1816,276,444,.622,0,0,,276,444,.622,.622,204,299,.682,165,436,601,80,44,129,107,153,756
179,Aaron Gordon\gordoaa01,PF,22,ORL,58,57,1909,375,865,.434,115,342,.336,260,523,.497,.500,157,225,.698,87,370,457,136,59,45,107,111,1022
180,Eric Gordon\gordoer01,SG,29,HOU,69,30,2154,415,970,.428,218,608,.359,197,362,.544,.540,195,241,.809,25,145,170,154,44,27,130,116,1243
181,Marcin Gortat\gortama01,C,33,WAS,82,82,2075,290,560,.518,0,0,,290,560,.518,.518,110,163,.675,181,442,623,151,40,61,99,175,690
182,Treveon Graham\grahatr01,SG,24,CHO,63,2,1050,96,221,.434,40,97,.412,56,124,.452,.525,41,59,.695,42,79,121,59,33,2,27,109,273
183,Jerami Grant\grantje01,PF,23,OKC,81,1,1647,244,456,.535,32,110,.291,212,346,.613,.570,162,240,.675,86,233,319,57,31,77,54,155,682
184,Jerian Grant\grantje02,PG,25,CHI,74,26,1686,209,503,.416,61,187,.326,148,316,.468,.476,140,188,.745,31,141,172,342,63,8,89,132,619
185,Josh Gray\grayjo01,PG,24,PHO,5,0,86,11,41,.268,3,13,.231,8,28,.286,.305,7,11,.636,2,8,10,12,8,2,7,8,32
186,Danny Green\greenda02,SG,30,SAS,70,60,1791,217,561,.387,116,320,.363,101,241,.419,.490,50,65,.769,41,208,249,110,63,80,74,122,600
187,Draymond Green\greendr01,PF,27,GSW,70,70,2287,281,619,.454,77,256,.301,204,363,.562,.516,134,173,.775,75,460,535,508,95,91,202,185,773
188,Gerald Green\greenge01,SG,32,HOU,41,2,929,168,413,.407,110,298,.369,58,115,.504,.540,51,60,.850,15,118,133,25,24,15,31,87,497
189,JaMychal Green\greenja01,PF,27,MEM,55,54,1542,223,488,.457,43,127,.339,180,361,.499,.501,80,111,.721,147,317,464,79,32,25,76,153,569
190,Jeff Green\greenje02,PF,31,CLE,78,13,1828,295,618,.477,53,170,.312,242,448,.540,.520,203,234,.868,60,186,246,99,41,34,75,149,846
191,Blake Griffin\griffbl01,PF,28,TOT,58,58,1970,436,996,.438,111,322,.345,325,674,.482,.493,259,330,.785,73,355,428,334,41,18,165,139,1242
191,Blake Griffin\griffbl01,PF,28,LAC,33,33,1139,255,578,.441,64,187,.342,191,391,.488,.497,172,219,.785,46,216,262,179,30,9,99,78,746
191,Blake Griffin\griffbl01,PF,28,DET,25,25,831,181,418,.433,47,135,.348,134,283,.473,.489,87,111,.784,27,139,166,155,11,9,66,61,496
192,Daniel Hamilton\hamilda02,SG,22,OKC,6,0,28,5,11,.455,2,5,.400,3,6,.500,.545,0,0,,0,5,5,8,1,0,2,2,12
193,Tim Hardaway\hardati02,SG,25,NYK,57,54,1885,360,856,.421,130,410,.317,230,446,.516,.496,146,179,.816,32,192,224,155,62,10,92,123,996
194,James Harden\hardeja01,SG,28,HOU,72,72,2551,651,1449,.449,265,722,.367,386,727,.531,.541,624,727,.858,41,348,389,630,126,50,315,169,2191
195,Maurice Harkless\harklma01,SF,24,POR,59,36,1264,147,297,.495,49,118,.415,98,179,.547,.577,42,59,.712,46,116,162,53,48,43,40,103,385
196,Montrezl Harrell\harremo01,C,24,LAC,76,3,1293,348,548,.635,1,7,.143,347,541,.641,.636,139,222,.626,103,203,306,74,36,52,68,143,836
197,Devin Harris\harride01,PG,34,TOT,71,1,1340,187,454,.412,79,227,.348,108,227,.476,.499,142,170,.835,12,115,127,152,47,12,76,158,595
197,Devin Harris\harride01,PG,34,DAL,44,1,807,118,284,.415,44,125,.352,74,159,.465,.493,93,112,.830,9,76,85,85,33,8,49,103,373
197,Devin Harris\harride01,PG,34,DEN,27,0,533,69,170,.406,35,102,.343,34,68,.500,.509,49,58,.845,3,39,42,67,14,4,27,55,222
198,Gary Harris\harriga01,SG,23,DEN,67,65,2304,440,908,.485,156,394,.396,284,514,.553,.570,134,162,.827,37,139,176,194,122,15,119,119,1170
199,Joe Harris\harrijo01,SG,26,BRK,78,14,1975,305,621,.491,150,358,.419,155,263,.589,.612,86,104,.827,51,209,260,128,35,20,91,153,846
200,Tobias Harris\harrito02,PF,25,TOT,80,80,2668,562,1221,.460,183,445,.411,379,776,.488,.535,179,216,.829,58,379,437,192,71,35,105,164,1486
200,Tobias Harris\harrito02,PF,25,DET,48,48,1563,320,709,.451,113,276,.409,207,433,.478,.531,115,136,.846,36,208,244,94,34,15,51,91,868
200,Tobias Harris\harrito02,PF,25,LAC,32,32,1105,242,512,.473,70,169,.414,172,343,.501,.541,64,80,.800,22,171,193,98,37,20,54,73,618
201,Aaron Harrison\harriaa01,SG,23,DAL,9,3,233,19,69,.275,9,43,.209,10,26,.385,.341,13,17,.765,4,20,24,11,9,2,3,27,60
202,Andrew Harrison\harrian01,PG,23,MEM,56,46,1326,181,429,.422,47,142,.331,134,287,.467,.477,124,159,.780,23,108,131,177,38,26,81,138,533
203,Shaquille Harrison\harrish01,PG,24,PHO,23,2,384,59,124,.476,6,26,.231,53,98,.541,.500,28,38,.737,9,52,61,55,26,7,22,42,152
204,Josh Hart\hartjo01,SG,22,LAL,63,23,1461,176,375,.469,78,197,.396,98,178,.551,.573,66,94,.702,42,221,263,80,47,16,47,107,496
205,Udonis Haslem\hasleud01,C,37,MIA,14,0,72,3,15,.200,1,8,.125,2,7,.286,.233,1,2,.500,3,7,10,5,0,2,2,3,8
206,Nigel Hayes\hayesni01,SF,23,TOT,9,0,122,11,33,.333,4,16,.250,7,17,.412,.394,1,3,.333,4,18,22,6,2,3,2,8,27
206,Nigel Hayes\hayesni01,SF,23,LAL,2,0,11,1,3,.333,0,2,.000,1,1,1.000,.333,1,1,1.000,0,0,0,2,0,0,0,0,3
206,Nigel Hayes\hayesni01,SF,23,TOR,2,0,6,2,2,1.000,2,2,1.000,0,0,,1.500,0,0,,0,0,0,0,0,0,1,0,6
206,Nigel Hayes\hayesni01,SF,23,SAC,5,0,105,8,28,.286,2,12,.167,6,16,.375,.321,0,2,.000,4,18,22,4,2,3,1,8,18
207,Gordon Hayward\haywago01,SF,27,BOS,1,1,5,1,2,.500,0,1,.000,1,1,1.000,.500,0,0,,0,1,1,0,0,0,0,1,2
208,Reggie Hearn\hearnre01,SG,26,DET,3,0,7,1,2,.500,1,2,.500,0,0,,.750,0,0,,0,0,0,0,0,0,0,0,3
209,Myke Henry\henrymy01,SF,25,MEM,20,0,378,41,109,.376,19,58,.328,22,51,.431,.463,6,10,.600,10,28,38,22,31,6,19,28,107
210,John Henson\hensojo01,C,27,MIL,76,69,1970,287,502,.572,1,7,.143,286,495,.578,.573,90,158,.570,150,363,513,114,45,109,84,202,665
211,Juan Hernangomez\hernaju01,PF,22,DEN,25,3,277,29,75,.387,14,50,.280,15,25,.600,.480,10,12,.833,18,36,54,12,6,3,9,25,82
212,Willy Hernangomez\hernawi01,C,23,TOT,48,1,495,91,164,.555,5,12,.417,86,152,.566,.570,59,90,.656,61,122,183,33,18,16,35,64,246
212,Willy Hernangomez\hernawi01,C,23,NYK,26,0,233,49,81,.605,1,5,.200,48,76,.632,.611,12,28,.429,22,45,67,21,8,7,26,32,111
212,Willy Hernangomez\hernawi01,C,23,CHO,22,1,262,42,83,.506,4,7,.571,38,76,.500,.530,47,62,.758,39,77,116,12,10,9,9,32,135
213,Mario Hezonja\hezonma01,SF,22,ORL,75,30,1657,273,617,.442,90,267,.337,183,350,.523,.515,86,105,.819,41,240,281,106,81,31,86,134,722
214,Isaiah Hicks\hicksis01,PF,23,NYK,18,0,240,33,72,.458,2,9,.222,31,63,.492,.472,12,18,.667,10,31,41,16,2,4,16,45,80
215,Buddy Hield\hieldbu01,SG,25,SAC,80,12,2024,416,933,.446,176,408,.431,240,525,.457,.540,71,81,.877,55,252,307,155,85,22,124,148,1079
216,Nene Hilario\hilarne01,C,35,HOU,52,4,758,136,239,.569,0,2,.000,136,237,.574,.569,68,107,.636,54,122,176,45,28,14,38,123,340
217,George Hill\hillge01,PG,31,TOT,67,60,1812,236,513,.460,85,205,.415,151,308,.490,.543,110,140,.786,42,139,181,186,61,27,88,128,667
217,George Hill\hillge01,PG,31,SAC,43,36,1143,153,326,.469,58,128,.453,95,198,.480,.558,77,99,.778,22,95,117,119,39,12,60,75,441
217,George Hill\hillge01,PG,31,CLE,24,24,669,83,187,.444,27,77,.351,56,110,.509,.516,33,41,.805,20,44,64,67,22,15,28,53,226
218,Solomon Hill\hillso01,SF,26,NOP,12,1,187,11,41,.268,4,21,.190,7,20,.350,.317,3,6,.500,9,27,36,22,7,1,9,22,29
219,Darrun Hilliard\hillida01,SG,24,SAS,14,0,95,5,19,.263,0,6,.000,5,13,.385,.263,6,7,.857,0,7,7,11,2,0,4,7,16
220,Jrue Holiday\holidjr01,SG,27,NOP,81,81,2927,615,1244,.494,120,356,.337,495,888,.557,.543,187,238,.786,62,303,365,486,123,64,213,201,1537
221,Justin Holiday\holidju01,SG,28,CHI,72,72,2265,290,782,.371,161,449,.359,129,333,.387,.474,135,164,.823,31,260,291,153,80,31,93,134,876
222,John Holland\hollajo02,SF,29,CLE,24,0,174,17,59,.288,11,36,.306,6,23,.261,.381,9,13,.692,6,18,24,5,7,2,8,10,54
223,Rondae Hollis-Jefferson\holliro01,SF,23,BRK,68,59,1920,342,724,.472,13,54,.241,329,670,.491,.481,249,316,.788,101,358,459,167,65,48,121,145,946
224,Richaun Holmes\holmeri01,C,24,PHI,48,2,746,135,241,.560,4,31,.129,131,210,.624,.568,37,56,.661,57,154,211,61,20,29,25,97,311
225,Rodney Hood\hoodro01,SG,25,TOT,60,23,1616,322,751,.429,127,333,.381,195,418,.467,.513,111,129,.860,22,143,165,95,45,12,70,105,882
225,Rodney Hood\hoodro01,SG,25,UTA,39,12,1084,234,552,.424,102,262,.389,132,290,.455,.516,85,97,.876,14,97,111,65,30,7,63,64,655
225,Rodney Hood\hoodro01,SG,25,CLE,21,11,532,88,199,.442,25,71,.352,63,128,.492,.505,26,32,.813,8,46,54,30,15,5,7,41,227
226,Scotty Hopson\hopsosc01,SG,28,DAL,1,0,8,0,1,.000,0,0,,0,1,.000,.000,1,2,.500,0,0,0,1,0,0,1,0,1
227,Al Horford\horfoal01,C,31,BOS,72,72,2277,368,753,.489,97,226,.429,271,527,.514,.553,94,120,.783,103,427,530,339,43,78,132,138,927
228,Danuel House\houseda01,SG,24,PHO,23,3,403,56,129,.434,15,58,.259,41,71,.577,.492,25,31,.806,13,63,76,25,7,6,11,23,152
229,Dwight Howard\howardw01,C,32,CHO,81,81,2463,506,911,.555,1,7,.143,505,904,.559,.556,334,582,.574,255,757,1012,105,48,131,208,249,1347
230,Josh Huestis\huestjo01,PF,26,OKC,69,10,982,60,182,.330,33,115,.287,27,67,.403,.420,6,20,.300,42,119,161,20,15,43,26,82,159
231,R.J. Hunter\hunterj01,SG,24,HOU,5,1,45,7,20,.350,3,14,.214,4,6,.667,.425,2,2,1.000,0,5,5,3,3,0,2,7,19
232,Vince Hunter\huntevi01,PF,23,MEM,4,0,7,3,5,.600,0,0,,3,5,.600,.600,0,0,,2,1,3,0,0,1,1,0,6
233,Serge Ibaka\ibakase01,PF,28,TOR,76,76,2093,379,784,.483,107,297,.360,272,487,.559,.552,94,118,.797,78,400,478,62,29,99,90,209,959
234,Andre Iguodala\iguodan01,SF,34,GSW,64,7,1622,148,320,.463,33,117,.282,115,203,.567,.514,55,87,.632,50,196,246,210,54,38,67,99,384
235,Ersan Ilyasova\ilyaser01,PF,30,TOT,69,43,1729,277,613,.452,91,253,.360,186,360,.517,.526,105,135,.778,118,287,405,90,61,26,72,157,750
235,Ersan Ilyasova\ilyaser01,PF,30,ATL,46,40,1175,184,401,.459,61,170,.359,123,231,.532,.535,72,90,.800,74,177,251,51,44,17,43,92,501
235,Ersan Ilyasova\ilyaser01,PF,30,PHI,23,3,554,93,212,.439,30,83,.361,63,129,.488,.509,33,45,.733,44,110,154,39,17,9,29,65,249
236,Joe Ingles\inglejo01,SF,30,UTA,82,81,2578,335,718,.467,204,464,.440,131,254,.516,.609,66,83,.795,24,320,344,392,90,20,159,178,940
237,Andre Ingram\ingraan01,SG,32,LAL,2,0,64,8,17,.471,5,9,.556,3,8,.375,.618,3,3,1.000,1,5,6,7,3,3,3,3,24
238,Brandon Ingram\ingrabr01,SF,20,LAL,59,59,1975,358,761,.470,41,105,.390,317,656,.483,.497,192,282,.681,57,257,314,230,45,43,149,163,949
239,Kyrie Irving\irvinky01,PG,25,BOS,60,60,1931,534,1087,.491,166,407,.408,368,680,.541,.568,232,261,.889,33,194,227,306,65,17,140,122,1466
240,Jonathan Isaac\isaacjo01,PF,20,ORL,27,10,536,55,145,.379,16,46,.348,39,99,.394,.434,19,25,.760,16,83,99,18,33,30,27,48,145
241,Wesley Iwundu\iwundwe01,SF,23,ORL,62,12,1020,93,218,.427,9,46,.196,84,172,.488,.447,34,47,.723,36,101,137,57,33,12,30,81,229
242,Jarrett Jack\jackja01,PG,34,NYK,62,56,1548,189,443,.427,25,86,.291,164,357,.459,.455,63,75,.840,22,169,191,348,35,4,115,98,466
243,Aaron Jackson\jacksaa01,PG,31,HOU,1,0,35,3,9,.333,1,4,.250,2,5,.400,.389,1,2,.500,2,1,3,1,0,0,1,4,8
244,Demetrius Jackson\jacksde01,PG,23,TOT,15,0,80,7,18,.389,1,7,.143,6,11,.545,.417,1,2,.500,5,7,12,9,5,1,10,7,16
244,Demetrius Jackson\jacksde01,PG,23,HOU,12,0,63,4,14,.286,0,6,.000,4,8,.500,.286,0,0,,4,7,11,5,4,1,9,6,8
244,Demetrius Jackson\jacksde01,PG,23,PHI,3,0,17,3,4,.750,1,1,1.000,2,3,.667,.875,1,2,.500,1,0,1,4,1,0,1,1,8
245,Josh Jackson\jacksjo02,SF,20,PHO,77,35,1959,389,932,.417,57,217,.263,332,715,.464,.448,177,279,.634,95,256,351,119,80,35,146,218,1012
246,Justin Jackson\jacksju01,SF,22,SAC,68,41,1506,185,419,.442,57,185,.308,128,234,.547,.510,26,36,.722,27,160,187,74,28,13,40,81,453
247,Reggie Jackson\jacksre01,PG,27,DET,45,45,1201,246,577,.426,52,169,.308,194,408,.475,.471,112,134,.836,29,96,125,238,27,4,99,87,656
248,LeBron James\jamesle01,PF,33,CLE,82,82,3026,857,1580,.542,149,406,.367,708,1174,.603,.590,388,531,.731,97,612,709,747,116,71,347,136,2251
249,Mike James\jamesmi02,PG,27,TOT,36,10,687,123,321,.383,26,98,.265,97,223,.435,.424,64,84,.762,13,77,90,126,28,7,49,48,336
249,Mike James\jamesmi02,PG,27,PHO,32,10,669,121,312,.388,26,97,.268,95,215,.442,.429,64,84,.762,12,77,89,120,27,7,48,45,332
249,Mike James\jamesmi02,PG,27,NOP,4,0,18,2,9,.222,0,1,.000,2,8,.250,.222,0,0,,1,0,1,6,1,0,1,3,4
250,Al Jefferson\jeffeal01,C,33,IND,36,1,484,111,208,.534,0,3,.000,111,205,.541,.534,30,36,.833,30,113,143,30,16,23,21,66,252
251,Richard Jefferson\jefferi01,SF,37,DEN,20,0,163,12,27,.444,2,7,.286,10,20,.500,.481,4,7,.571,2,15,17,15,2,1,5,11,30
252,Brandon Jennings\jennibr01,PG,28,MIL,14,0,205,27,72,.375,9,33,.273,18,39,.462,.438,10,10,1.000,5,26,31,44,6,4,18,11,73
253,Jonas Jerebko\jerebjo01,PF,30,UTA,74,19,1134,159,341,.466,65,157,.414,94,184,.511,.562,46,57,.807,53,193,246,42,24,12,27,127,429
254,Amir Johnson\johnsam01,C,30,PHI,74,18,1171,140,260,.538,10,32,.313,130,228,.570,.558,52,85,.612,123,207,330,118,45,44,55,192,342
255,Brice Johnson\johnsbr02,PF,23,TOT,18,0,98,20,42,.476,0,1,.000,20,41,.488,.476,3,5,.600,9,22,31,2,9,6,5,13,43
255,Brice Johnson\johnsbr02,PF,23,LAC,9,0,38,7,11,.636,0,1,.000,7,10,.700,.636,2,2,1.000,2,11,13,1,6,2,4,7,16
255,Brice Johnson\johnsbr02,PF,23,MEM,9,0,60,13,31,.419,0,0,,13,31,.419,.419,1,3,.333,7,11,18,1,3,4,1,6,27
256,Dakari Johnson\johnsda04,C,22,OKC,31,6,161,22,39,.564,0,0,,22,39,.564,.564,11,20,.550,16,18,34,8,6,8,3,27,55
257,James Johnson\johnsja01,PF,30,MIA,73,41,1943,309,614,.503,57,185,.308,252,429,.587,.550,113,162,.698,61,297,358,280,70,51,141,192,788
258,Joe Johnson\johnsjo02,SF,36,TOT,55,4,1205,146,360,.406,40,145,.276,106,215,.493,.461,40,45,.889,14,158,172,83,18,7,49,67,372
258,Joe Johnson\johnsjo02,SF,36,UTA,32,3,700,95,226,.420,23,84,.274,72,142,.507,.471,20,24,.833,12,95,107,45,12,6,31,32,233
258,Joe Johnson\johnsjo02,SF,36,HOU,23,1,505,51,134,.381,17,61,.279,34,73,.466,.444,20,21,.952,2,63,65,38,6,1,18,35,139
259,Omari Johnson\johnsom01,PF,28,MEM,4,0,75,9,21,.429,4,12,.333,5,9,.556,.524,0,0,,4,7,11,7,2,0,3,6,22
260,Stanley Johnson\johnsst04,SF,21,DET,69,50,1894,210,560,.375,67,234,.286,143,326,.439,.435,112,145,.772,33,219,252,112,95,14,77,169,599
261,Tyler Johnson\johnsty01,PG,25,MIA,72,39,2052,309,711,.435,119,324,.367,190,387,.491,.518,106,129,.822,34,214,248,165,60,34,81,148,843
262,Wesley Johnson\johnswe01,SF,30,LAC,74,40,1486,150,368,.408,60,177,.339,90,191,.471,.489,43,58,.741,29,187,216,61,76,62,55,146,403
263,Nikola Jokic\jokicni01,C,22,DEN,75,73,2443,504,1010,.499,111,280,.396,393,730,.538,.554,266,313,.850,195,608,803,458,90,61,210,212,1385
264,Damian Jones\jonesda03,C,22,GSW,15,0,89,11,22,.500,0,0,,11,22,.500,.500,3,5,.600,5,9,14,2,1,3,4,14,25
265,Derrick Jones\jonesde02,SF,20,TOT,20,8,245,21,53,.396,3,18,.167,18,35,.514,.425,16,24,.667,21,17,38,9,4,13,7,24,61
265,Derrick Jones\jonesde02,SF,20,PHO,6,0,33,2,4,.500,0,2,.000,2,2,1.000,.500,5,6,.833,2,2,4,3,1,4,1,2,9
265,Derrick Jones\jonesde02,SF,20,MIA,14,8,212,19,49,.388,3,16,.188,16,33,.485,.418,11,18,.611,19,15,34,6,3,9,6,22,52
266,Jalen Jones\jonesja04,SF,24,TOT,16,0,181,26,68,.382,10,26,.385,16,42,.381,.456,12,19,.632,13,25,38,4,5,1,7,22,74
266,Jalen Jones\jonesja04,SF,24,NOP,4,0,19,1,4,.250,1,1,1.000,0,3,.000,.375,2,2,1.000,0,3,3,0,0,0,0,2,5
266,Jalen Jones\jonesja04,SF,24,DAL,12,0,162,25,64,.391,9,25,.360,16,39,.410,.461,10,17,.588,13,22,35,4,5,1,7,20,69
267,Tyus Jones\jonesty01,PG,21,MIN,82,11,1467,150,328,.457,45,129,.349,105,199,.528,.526,71,81,.877,16,116,132,232,95,6,59,110,416
268,DeAndre Jordan\jordade01,C,29,LAC,77,77,2424,373,578,.645,0,0,,373,578,.645,.645,181,312,.580,329,842,1171,117,39,71,137,203,927
269,Cory Joseph\josepco01,PG,26,IND,82,17,2210,256,604,.424,67,190,.353,189,414,.457,.479,70,94,.745,39,224,263,260,80,18,87,141,649
270,Frank Kaminsky\kaminfr01,PF,24,CHO,79,4,1835,307,716,.429,104,274,.380,203,442,.459,.501,155,194,.799,46,242,288,129,36,19,66,95,873
271,Enes Kanter\kanteen01,C,25,NYK,71,71,1830,422,713,.592,0,2,.000,422,711,.594,.592,156,184,.848,273,507,780,105,36,37,122,187,1000
272,Luke Kennard\kennalu01,SG,21,DET,73,9,1463,206,465,.443,81,195,.415,125,270,.463,.530,65,76,.855,21,155,176,124,44,13,69,86,558
273,Michael Kidd-Gilchrist\kiddgmi01,SF,24,CHO,74,74,1850,282,560,.504,0,2,.000,282,558,.505,.504,117,171,.684,84,218,302,71,51,32,53,143,681
274,Sean Kilpatrick\kilpase01,SG,28,TOT,52,1,640,110,294,.374,46,144,.319,64,150,.427,.452,64,72,.889,5,82,87,46,13,5,38,33,330
274,Sean Kilpatrick\kilpase01,SG,28,BRK,16,0,183,25,87,.287,11,43,.256,14,44,.318,.351,18,19,.947,1,34,35,15,2,1,16,8,79
274,Sean Kilpatrick\kilpase01,SG,28,MIL,23,0,205,31,82,.378,13,46,.283,18,36,.500,.457,18,19,.947,1,24,25,15,5,1,9,15,93
274,Sean Kilpatrick\kilpase01,SG,28,LAC,4,0,38,7,18,.389,3,7,.429,4,11,.364,.472,2,2,1.000,0,2,2,3,0,0,1,2,19
274,Sean Kilpatrick\kilpase01,SG,28,CHI,9,1,214,47,107,.439,19,48,.396,28,59,.475,.528,26,32,.813,3,22,25,13,6,3,12,8,139
275,Maxi Kleber\klebima01,PF,26,DAL,72,36,1206,151,309,.489,40,128,.313,111,181,.613,.553,44,59,.746,71,163,234,51,26,47,30,114,386
276,Furkan Korkmaz\korkmfu01,SG,20,PHI,14,0,80,8,28,.286,5,17,.294,3,11,.273,.375,2,4,.500,2,9,11,4,2,1,2,12,23
277,Luke Kornet\kornelu01,PF,22,NYK,20,1,326,49,125,.392,28,79,.354,21,46,.457,.504,8,11,.727,11,53,64,26,6,16,12,28,134
278,Kyle Korver\korveky01,SG,36,CLE,73,4,1574,222,484,.459,164,376,.436,58,108,.537,.628,64,72,.889,9,156,165,88,31,27,55,130,672
279,Kosta Koufos\koufoko01,C,28,SAC,71,13,1391,222,389,.571,0,0,,222,389,.571,.571,33,74,.446,149,323,472,87,47,32,49,146,477
280,Kyle Kuzma\kuzmaky01,PF,22,LAL,77,37,2401,468,1039,.450,159,434,.366,309,605,.511,.527,147,208,.707,88,395,483,141,49,34,140,160,1242
281,Mindaugas Kuzminskas\kuzmimi01,SF,28,NYK,1,0,2,0,2,.000,0,0,,0,2,.000,.000,0,0,,0,0,0,0,0,0,0,0,0
282,Skal Labissiere\labissk01,PF,21,SAC,60,28,1240,205,458,.448,18,51,.353,187,407,.459,.467,95,118,.805,99,189,288,72,25,49,73,132,523
283,Jeremy Lamb\lambje01,SG,25,CHO,80,18,1967,380,832,.457,94,254,.370,286,578,.495,.513,179,208,.861,49,275,324,186,61,32,93,138,1033
284,Shane Larkin\larkish01,PG,25,BOS,54,2,775,84,219,.384,31,86,.360,53,133,.398,.454,32,37,.865,15,77,92,98,29,2,33,58,231
285,Joffrey Lauvergne\lauvejo01,C,26,SAS,55,1,534,98,190,.516,0,5,.000,98,185,.530,.516,30,47,.638,63,108,171,41,9,3,33,45,226
286,Zach LaVine\lavinza01,SG,22,CHI,24,24,656,136,355,.383,42,123,.341,94,232,.405,.442,87,107,.813,9,85,94,72,24,4,43,55,401
287,Jake Layman\laymaja01,SF,23,POR,35,1,160,14,47,.298,4,20,.200,10,27,.370,.340,2,3,.667,4,12,16,11,6,4,5,13,34
288,T.J. Leaf\leaftj01,PF,20,IND,53,0,459,64,136,.471,18,42,.429,46,94,.489,.537,10,16,.625,29,53,82,9,5,4,10,45,156
289,Courtney Lee\leeco01,SG,32,NYK,76,69,2310,343,755,.454,113,278,.406,230,477,.482,.529,114,124,.919,30,194,224,180,80,17,84,109,913
290,Damion Lee\leeda03,SG,25,ATL,15,11,404,62,152,.408,15,60,.250,47,92,.511,.457,22,29,.759,11,60,71,29,19,1,14,25,161
291,Walt Lemon\lemonwa01,PG,25,NOP,5,0,35,7,16,.438,1,1,1.000,6,15,.400,.469,2,3,.667,0,2,2,5,0,1,4,5,17
292,Alex Len\lenal01,C,24,PHO,69,13,1395,214,378,.566,1,3,.333,213,375,.568,.567,158,231,.684,175,343,518,82,27,61,78,158,587
293,Kawhi Leonard\leonaka01,SF,26,SAS,9,9,210,52,111,.468,11,35,.314,41,76,.539,.518,31,38,.816,6,36,42,21,18,9,16,9,146
294,Meyers Leonard\leoname01,C,25,POR,33,2,254,46,78,.590,11,26,.423,35,52,.673,.660,9,11,.818,12,58,70,17,7,0,10,36,112
295,Jon Leuer\leuerjo01,PF,28,DET,8,0,136,15,36,.417,0,3,.000,15,33,.455,.417,13,15,.867,7,25,32,5,1,3,7,16,43
296,Caris LeVert\leverca01,SF,23,BRK,71,10,1864,320,735,.435,85,245,.347,235,490,.480,.493,133,187,.711,53,207,260,299,82,22,153,159,858
297,DeAndre Liggins\liggide01,SG,29,TOT,58,4,724,40,106,.377,19,53,.358,21,53,.396,.467,2,5,.400,7,68,75,48,37,14,20,81,101
297,DeAndre Liggins\liggide01,SG,29,MIL,31,1,480,22,65,.338,11,36,.306,11,29,.379,.423,2,5,.400,5,44,49,27,27,10,13,61,57
297,DeAndre Liggins\liggide01,SG,29,NOP,27,3,244,18,41,.439,8,17,.471,10,24,.417,.537,0,0,,2,24,26,21,10,4,7,20,44
298,Damian Lillard\lillada01,PG,27,POR,73,73,2670,621,1415,.439,227,629,.361,394,786,.501,.519,493,538,.916,62,263,325,481,77,27,206,117,1962
299,Jeremy Lin\linje01,PG,29,BRK,1,1,25,5,12,.417,1,2,.500,4,10,.400,.458,7,7,1.000,0,0,0,4,0,0,3,3,18
300,Shaun Livingston\livinsh01,PG,32,GSW,71,7,1129,172,343,.501,0,5,.000,172,338,.509,.501,50,61,.820,32,99,131,140,35,21,58,117,394
301,Kevon Looney\looneke01,C,21,GSW,66,4,910,112,193,.580,1,5,.200,111,188,.590,.583,42,77,.545,83,132,215,42,34,56,31,106,267
302,Brook Lopez\lopezbr01,C,29,LAL,74,72,1735,369,793,.465,112,325,.345,257,468,.549,.536,111,158,.703,74,220,294,126,30,98,98,195,961
303,Robin Lopez\lopezro01,C,29,CHI,64,64,1690,342,645,.530,4,14,.286,338,631,.536,.533,68,90,.756,134,156,290,124,14,53,107,109,756
304,Kevin Love\loveke01,C,29,CLE,59,59,1651,334,729,.458,137,330,.415,197,399,.494,.552,234,266,.880,101,445,546,103,43,24,90,120,1039
305,Kyle Lowry\lowryky01,PG,31,TOR,78,78,2510,403,944,.427,238,596,.399,165,348,.474,.553,223,261,.854,66,368,434,537,85,19,183,192,1267
306,Timothe Luwawu-Cabarrot\luwawti01,SF,22,PHI,52,7,807,100,267,.375,53,158,.335,47,109,.431,.474,46,58,.793,14,58,72,54,12,5,38,97,299
307,Tyler Lydon\lydonty01,PF,21,DEN,1,0,2,0,0,,0,0,,0,0,,,0,0,,0,0,0,0,0,0,0,0,0
308,Trey Lyles\lylestr01,PF,22,DEN,73,2,1391,270,550,.491,83,218,.381,187,332,.563,.566,101,143,.706,55,292,347,91,30,34,61,111,724
309,Shelvin Mack\macksh01,PG,27,ORL,69,3,1365,178,414,.430,48,139,.345,130,275,.473,.488,69,97,.711,23,143,166,272,54,8,89,91,473
310,Josh Magette\magetjo01,PG,28,ATL,18,0,216,15,46,.326,8,22,.364,7,24,.292,.413,8,8,1.000,2,17,19,57,8,1,9,16,46
311,Ian Mahinmi\mahinia01,C,31,WAS,77,0,1145,138,248,.556,0,2,.000,138,246,.561,.556,90,128,.703,135,177,312,53,38,42,100,230,366
312,Thon Maker\makerth01,C,20,MIL,74,12,1238,130,316,.411,31,104,.298,99,212,.467,.460,65,93,.699,75,150,225,46,38,53,44,162,356
313,Boban Marjanovic\marjabo01,C,29,TOT,39,1,337,79,148,.534,0,0,,79,148,.534,.534,77,97,.794,48,96,144,22,10,11,36,51,235
313,Boban Marjanovic\marjabo01,C,29,DET,19,1,171,41,79,.519,0,0,,41,79,.519,.519,36,45,.800,15,42,57,14,4,6,22,28,118
313,Boban Marjanovic\marjabo01,C,29,LAC,20,0,166,38,69,.551,0,0,,38,69,.551,.551,41,52,.788,33,54,87,8,6,5,14,23,117
314,Lauri Markkanen\markkla01,PF,20,CHI,68,68,2020,374,862,.434,145,401,.362,229,461,.497,.518,140,166,.843,79,429,508,79,39,40,83,103,1033
315,Jarell Martin\martija01,PF,23,MEM,73,36,1661,221,496,.446,34,98,.347,187,398,.470,.480,89,116,.767,97,221,318,73,39,49,86,211,565
316,Frank Mason\masonfr01,PG,23,SAC,52,2,984,144,380,.379,31,86,.360,113,294,.384,.420,94,115,.817,30,100,130,147,34,10,65,72,413
317,Mangok Mathiang\mathima01,C,25,CHO,4,0,20,4,7,.571,0,0,,4,7,.571,.571,0,1,.000,3,7,10,0,1,0,0,5,8
318,Wesley Matthews\matthwe02,SF,31,DAL,63,62,2131,283,697,.406,153,402,.381,130,295,.441,.516,83,101,.822,28,170,198,172,76,16,83,140,802
319,Luc Mbah a Moute\mbahalu01,PF,31,HOU,61,15,1564,166,345,.481,63,173,.364,103,172,.599,.572,65,95,.684,22,164,186,55,72,25,68,100,460
320,James Michael McAdoo\mcadoja01,PF,25,PHI,3,0,18,2,7,.286,2,7,.286,0,0,,.429,2,2,1.000,0,2,2,0,0,1,1,1,8
321,Patrick McCaw\mccawpa01,SG,22,GSW,57,10,961,92,225,.409,19,80,.238,73,145,.503,.451,26,34,.765,16,66,82,81,43,10,41,67,229
322,CJ McCollum\mccolcj01,SG,26,POR,81,81,2923,667,1505,.443,189,476,.397,478,1029,.465,.506,209,250,.836,53,268,321,272,77,35,151,168,1732
323,T.J. McConnell\mccontj01,PG,25,PHI,76,1,1706,210,421,.499,27,62,.435,183,359,.510,.531,31,39,.795,37,189,226,303,92,13,112,122,478
324,Erik McCree\mccreer01,SF,24,UTA,4,0,8,0,2,.000,0,1,.000,0,1,.000,.000,0,0,,0,1,1,0,1,0,1,0,0
325,Chris McCullough\mcculch01,PF,22,WAS,19,0,90,18,42,.429,1,8,.125,17,34,.500,.440,9,14,.643,7,18,25,4,0,5,2,8,46
326,Doug McDermott\mcderdo01,SF,26,TOT,81,4,1768,237,508,.467,92,216,.426,145,292,.497,.557,64,81,.790,40,160,200,79,19,16,56,122,630
326,Doug McDermott\mcderdo01,SF,26,NYK,55,1,1172,151,328,.460,53,137,.387,98,191,.513,.541,40,53,.755,33,101,134,50,10,12,34,73,395
326,Doug McDermott\mcderdo01,SF,26,DAL,26,3,596,86,180,.478,39,79,.494,47,101,.465,.586,24,28,.857,7,59,66,29,9,4,22,49,235
327,JaVale McGee\mcgeeja01,C,30,GSW,65,17,615,136,219,.621,0,6,.000,136,213,.638,.621,38,52,.731,59,110,169,33,21,57,27,91,310
328,Rodney McGruder\mcgruro01,SG,26,MIA,18,2,299,36,73,.493,15,35,.429,21,38,.553,.596,4,8,.500,11,21,32,17,8,3,4,21,91
329,Trey McKinney-Jones\mckintr01,SG,27,IND,1,0,1,0,0,,0,0,,0,0,,,0,0,,0,0,0,0,0,0,0,0,0
330,Alfonzo McKinnie\mckinal01,SF,25,TOR,14,0,53,8,15,.533,3,9,.333,5,6,.833,.633,2,3,.667,1,6,7,1,1,1,3,8,21
331,Ben McLemore\mclembe01,SG,24,MEM,56,17,1091,157,373,.421,55,159,.346,102,214,.477,.495,53,64,.828,34,105,139,51,38,15,61,139,422
332,Josh McRoberts\mcrobjo01,PF,30,DAL,2,0,6,0,1,.000,0,1,.000,0,0,,.000,0,0,,0,0,0,0,0,0,0,2,0
333,Jodie Meeks\meeksjo01,SG,30,WAS,77,0,1119,157,393,.399,72,210,.343,85,183,.464,.491,101,117,.863,15,111,126,70,29,4,37,55,487
334,Salah Mejri\mejrisa01,C,31,DAL,61,1,729,88,137,.642,0,3,.000,88,134,.657,.642,38,66,.576,85,161,246,35,22,67,39,121,214
335,Jordan Mickey\mickejo01,PF,23,MIA,23,3,284,39,82,.476,2,16,.125,37,66,.561,.488,13,19,.684,18,63,81,9,6,10,18,36,93
336,Khris Middleton\middlkh01,SF,26,MIL,82,82,2982,593,1272,.466,146,407,.359,447,865,.517,.524,320,362,.884,45,384,429,328,119,21,191,270,1652
337,C.J. Miles\milescj01,SF,30,TOR,70,3,1337,227,599,.379,164,454,.361,63,145,.434,.516,81,97,.835,18,134,152,55,37,21,39,134,699
338,Darius Miller\milleda01,SF,27,NOP,82,3,1944,216,487,.444,147,358,.411,69,129,.535,.594,58,67,.866,18,146,164,111,28,17,58,160,637
339,Malcolm Miller\millema01,SF,24,TOR,15,4,126,13,28,.464,8,21,.381,5,7,.714,.607,4,4,1.000,4,11,15,3,1,2,5,10,38
340,Patty Mills\millspa02,PG,29,SAS,82,36,2107,280,682,.411,154,414,.372,126,268,.470,.523,105,118,.890,26,128,154,229,55,11,106,128,819
341,Paul Millsap\millspa01,PF,32,DEN,38,37,1143,202,435,.464,39,113,.345,163,322,.506,.509,112,161,.696,65,180,245,105,39,44,73,99,555
342,Nikola Mirotic\mirotni01,PF,26,TOT,55,14,1494,306,684,.447,135,358,.377,171,326,.525,.546,112,137,.818,59,346,405,80,44,39,62,108,859
342,Nikola Mirotic\mirotni01,PF,26,CHI,25,3,622,143,302,.474,69,161,.429,74,141,.525,.588,65,79,.823,18,141,159,39,15,13,31,45,420
342,Nikola Mirotic\mirotni01,PF,26,NOP,30,11,872,163,382,.427,66,197,.335,97,185,.524,.513,47,58,.810,41,205,246,41,29,26,31,63,439
343,Donovan Mitchell\mitchdo01,SG,21,UTA,79,71,2638,595,1362,.437,187,550,.340,408,812,.502,.506,239,297,.805,52,244,296,291,118,27,215,213,1616
344,Naz Mitrou-Long\mitrona01,SG,24,UTA,1,0,1,1,1,1.000,1,1,1.000,0,0,,1.500,0,0,,0,0,0,0,0,0,0,0,3
345,Malik Monk\monkma01,SG,19,CHO,63,0,854,153,425,.360,83,243,.342,70,182,.385,.458,32,38,.842,8,58,66,91,20,9,49,60,421
346,Greg Monroe\monrogr01,C,27,TOT,51,14,1040,218,386,.565,0,0,,218,386,.565,.565,88,119,.739,109,241,350,114,44,23,94,95,524
346,Greg Monroe\monrogr01,C,27,MIL,5,0,79,16,33,.485,0,0,,16,33,.485,.485,2,4,.500,6,19,25,5,0,0,6,7,34
346,Greg Monroe\monrogr01,C,27,PHO,20,14,465,97,155,.626,0,0,,97,155,.626,.626,31,46,.674,50,110,160,50,16,6,40,40,225
346,Greg Monroe\monrogr01,C,27,BOS,26,0,496,105,198,.530,0,0,,105,198,.530,.530,55,69,.797,53,112,165,59,28,17,48,48,265
347,Luis Montero\montelu01,SG,24,DET,2,0,8,0,1,.000,0,0,,0,1,.000,.000,0,0,,0,2,2,0,0,0,2,0,0
348,Ben Moore\moorebe01,PF,22,IND,2,0,9,0,0,,0,0,,0,0,,,0,0,,0,1,1,1,0,0,0,4,0
349,E'Twaun Moore\mooreet01,SG,28,NOP,82,80,2586,423,832,.508,128,301,.425,295,531,.556,.585,48,68,.706,57,181,238,187,79,12,102,182,1022
350,Eric Moreland\moreler01,PF,26,DET,67,3,805,66,122,.541,0,0,,66,122,.541,.541,11,29,.379,81,197,278,78,31,51,42,116,143
351,Jaylen Morris\morrija01,SG,22,ATL,6,0,98,13,32,.406,2,10,.200,11,22,.500,.438,0,0,,2,14,16,7,2,1,6,2,28
352,Marcus Morris\morrima03,PF,28,BOS,54,21,1447,262,611,.429,86,234,.368,176,377,.467,.499,124,154,.805,43,246,289,72,35,12,65,100,734
353,Markieff Morris\morrima02,PF,28,WAS,73,73,1968,330,687,.480,76,207,.367,254,480,.529,.536,105,128,.820,75,334,409,142,56,38,127,216,841
354,Monte Morris\morrimo01,PG,22,DEN,3,0,25,4,6,.667,0,1,.000,4,5,.800,.667,2,2,1.000,0,2,2,7,3,0,1,1,10
355,Johnathan Motley\motlejo01,PF,22,DAL,11,4,176,40,75,.533,1,6,.167,39,69,.565,.540,15,28,.536,14,35,49,7,3,2,9,18,96
356,Timofey Mozgov\mozgoti01,C,31,BRK,31,13,359,52,93,.559,4,18,.222,48,75,.640,.581,23,30,.767,32,66,98,11,5,13,33,39,131
357,Emmanuel Mudiay\mudiaem01,PG,21,TOT,64,14,1245,204,526,.388,47,148,.318,157,378,.415,.433,98,129,.760,26,126,152,206,41,11,113,80,553
357,Emmanuel Mudiay\mudiaem01,PG,21,DEN,42,0,752,129,322,.401,38,102,.373,91,220,.414,.460,63,78,.808,16,78,94,121,21,4,72,47,359
357,Emmanuel Mudiay\mudiaem01,PG,21,NYK,22,14,493,75,204,.368,9,46,.196,66,158,.418,.390,35,51,.686,10,48,58,85,20,7,41,33,194
358,Shabazz Muhammad\muhamsh01,SF-SG,25,TOT,43,2,418,84,188,.447,7,27,.259,77,161,.478,.465,39,50,.780,23,53,76,14,9,3,6,30,214
358,Shabazz Muhammad\muhamsh01,SF,25,MIN,32,2,301,47,121,.388,4,19,.211,43,102,.422,.405,22,31,.710,15,30,45,7,5,2,5,23,120
358,Shabazz Muhammad\muhamsh01,SG,25,MIL,11,0,117,37,67,.552,3,8,.375,34,59,.576,.575,17,19,.895,8,23,31,7,4,1,1,7,94
359,Xavier Munford\munfoxa02,SG,25,MIL,6,0,21,1,6,.167,0,2,.000,1,4,.250,.167,1,2,.500,1,0,1,4,1,0,2,4,3
360,Dejounte Murray\murrade01,PG,21,SAS,81,48,1743,270,609,.443,9,34,.265,261,575,.454,.451,105,148,.709,110,349,459,231,97,31,134,151,654
361,Jamal Murray\murraja01,PG,20,DEN,81,80,2565,479,1062,.451,165,436,.378,314,626,.502,.529,229,253,.905,82,215,297,274,79,28,172,173,1352
362,Mike Muscala\muscami01,C,26,ATL,53,7,1060,143,312,.458,62,167,.371,81,145,.559,.558,57,62,.919,56,174,230,51,31,27,42,80,405
363,Abdel Nader\naderab01,SF,24,BOS,48,1,522,50,149,.336,23,65,.354,27,84,.321,.413,23,39,.590,13,58,71,26,15,10,34,45,146
364,Larry Nance\nancela02,C,25,TOT,66,27,1421,240,413,.581,2,12,.167,238,401,.594,.584,91,137,.664,161,291,452,82,88,38,51,172,573
364,Larry Nance\nancela02,C,25,LAL,42,17,922,152,253,.601,1,4,.250,151,249,.606,.603,55,87,.632,108,176,284,57,59,20,41,113,360
364,Larry Nance\nancela02,C,25,CLE,24,10,499,88,160,.550,1,8,.125,87,152,.572,.553,36,50,.720,53,115,168,25,29,18,10,59,213
365,Shabazz Napier\napiesh01,PG,26,POR,74,10,1535,223,531,.420,82,218,.376,141,313,.450,.497,116,138,.841,26,144,170,150,81,14,90,84,644
366,Jameer Nelson\nelsoja01,PG,35,TOT,50,0,1013,95,244,.389,41,124,.331,54,120,.450,.473,16,20,.800,13,91,104,179,27,4,67,81,247
366,Jameer Nelson\nelsoja01,PG,35,NOP,43,0,897,84,205,.410,40,110,.364,44,95,.463,.507,13,17,.765,11,85,96,156,23,3,56,67,221
366,Jameer Nelson\nelsoja01,PG,35,DET,7,0,116,11,39,.282,1,14,.071,10,25,.400,.295,3,3,1.000,2,6,8,23,4,1,11,14,26
367,Raul Neto\netora01,PG,25,UTA,41,0,498,69,151,.457,19,47,.404,50,104,.481,.520,26,35,.743,7,42,49,75,13,4,36,38,183
368,Georges Niang\niangge01,PF,24,UTA,9,0,32,4,11,.364,0,4,.000,4,7,.571,.364,1,2,.500,3,6,9,3,2,0,3,1,9
369,Joakim Noah\noahjo01,C,32,NYK,7,0,40,5,10,.500,0,0,,5,10,.500,.500,2,4,.500,6,8,14,4,2,2,4,5,12
370,Nerlens Noel\noelne01,C,23,DAL,30,6,472,55,105,.524,0,1,.000,55,104,.529,.524,21,28,.750,48,120,168,20,31,22,26,59,131
371,Lucas Nogueira\noguelu01,C,25,TOR,49,3,418,49,80,.613,5,19,.263,44,61,.721,.644,19,28,.679,18,69,87,22,23,43,16,49,122
372,Dirk Nowitzki\nowitdi01,C,39,DAL,77,77,1900,346,758,.456,138,337,.409,208,421,.494,.547,97,108,.898,22,416,438,120,43,45,51,146,927
373,Frank Ntilikina\ntilila01,PG,19,NYK,78,9,1706,182,500,.364,50,157,.318,132,343,.385,.414,49,68,.721,37,140,177,250,65,18,131,181,463
374,Jusuf Nurkic\nurkiju01,C,23,POR,79,79,2088,480,951,.505,0,7,.000,480,944,.508,.505,172,273,.630,189,519,708,143,64,111,183,247,1132
375,David Nwaba\nwabada01,SG,25,CHI,70,21,1646,202,423,.478,18,52,.346,184,371,.496,.499,133,203,.655,89,237,326,104,59,29,77,158,555
376,Johnny O'Bryant\obryajo01,PF,24,CHO,36,0,379,68,171,.398,14,43,.326,54,128,.422,.439,21,25,.840,29,64,93,14,9,6,15,45,171
377,Royce O'Neale\onealro01,SF,24,UTA,69,4,1150,120,284,.423,42,118,.356,78,166,.470,.496,61,76,.803,25,211,236,95,36,16,55,105,343
378,Kyle O'Quinn\oquinky01,C,27,NYK,77,10,1387,224,384,.583,4,17,.235,220,367,.599,.589,98,127,.772,121,349,470,158,36,98,100,192,550
379,Semi Ojeleye\ojelese01,PF,23,BOS,73,0,1150,65,188,.346,40,125,.320,25,63,.397,.452,25,41,.610,37,124,161,20,21,4,25,91,195
380,Emeka Okafor\okafoem01,C,35,NOP,26,19,353,48,95,.505,0,0,,48,95,.505,.505,18,22,.818,47,73,120,8,8,25,13,30,114
381,Jahlil Okafor\okafoja01,C,22,TOT,28,0,353,77,138,.558,1,4,.250,76,134,.567,.562,21,29,.724,21,64,85,12,3,18,21,51,176
381,Jahlil Okafor\okafoja01,C,22,PHI,2,0,25,4,9,.444,0,0,,4,9,.444,.444,2,4,.500,4,5,9,1,0,2,3,7,10
381,Jahlil Okafor\okafoja01,C,22,BRK,26,0,328,73,129,.566,1,4,.250,72,125,.576,.570,19,25,.760,17,59,76,11,3,16,18,44,166
382,Victor Oladipo\oladivi01,SG,25,IND,75,75,2552,640,1342,.477,161,434,.371,479,908,.528,.537,294,368,.799,47,343,390,323,177,57,219,175,1735
383,Kelly Olynyk\olynyke01,PF,26,MIA,76,22,1779,316,636,.497,106,280,.379,210,356,.590,.580,134,174,.770,89,342,431,207,62,35,147,222,872
384,Chinanu Onuaku\onuakch01,C,21,HOU,1,0,22,2,5,.400,0,0,,2,5,.400,.400,0,0,,1,3,4,1,0,0,3,4,4
385,Cedi Osman\osmande01,SF,22,CLE,61,12,672,90,186,.484,32,87,.368,58,99,.586,.570,26,46,.565,19,101,120,41,22,3,32,78,238
386,Kelly Oubre\oubreke01,SF,22,WAS,81,11,2231,318,790,.403,126,369,.341,192,421,.456,.482,191,233,.820,59,304,363,98,80,35,90,234,953
387,Zaza Pachulia\pachuza01,C,33,GSW,69,57,972,149,264,.564,0,1,.000,149,263,.567,.564,75,93,.806,89,232,321,109,38,17,72,122,373
388,Marcus Paige\paigema01,PG,24,CHO,5,0,28,4,14,.286,2,8,.250,2,6,.333,.357,2,2,1.000,0,4,4,3,0,0,0,0,12
389,Georgios Papagiannis\papagge01,C,20,TOT,17,0,122,18,42,.429,0,0,,18,42,.429,.429,0,0,,13,24,37,9,4,6,8,12,36
389,Georgios Papagiannis\papagge01,C,20,SAC,16,0,118,17,41,.415,0,0,,17,41,.415,.415,0,0,,12,24,36,9,2,6,8,12,34
389,Georgios Papagiannis\papagge01,C,20,POR,1,0,4,1,1,1.000,0,0,,1,1,1.000,1.000,0,0,,1,0,1,0,2,0,0,0,2
390,Jabari Parker\parkeja01,PF,22,MIL,31,3,743,160,332,.482,31,81,.383,129,251,.514,.529,40,54,.741,42,109,151,59,25,10,45,50,391
391,Tony Parker\parketo01,PG,35,SAS,55,21,1071,178,388,.459,10,37,.270,168,351,.479,.472,55,78,.705,7,88,95,195,28,1,68,52,421
392,Chandler Parsons\parsoch01,SF,29,MEM,36,8,691,108,234,.462,51,121,.421,57,113,.504,.571,17,27,.630,14,76,90,69,18,11,35,53,284
393,Patrick Patterson\pattepa01,PF,28,OKC,82,3,1270,106,266,.398,66,171,.386,40,95,.421,.523,40,46,.870,32,161,193,57,48,23,33,87,318
394,Justin Patton\pattoju01,C,20,MIN,1,0,4,1,2,.500,0,0,,1,2,.500,.500,0,0,,0,0,0,0,1,0,0,1,2
395,Brandon Paul\paulbr01,SG,26,SAS,64,2,576,55,127,.433,15,54,.278,40,73,.548,.492,22,43,.512,6,62,68,37,25,7,29,58,147
396,Chris Paul\paulch01,PG,32,HOU,58,58,1847,367,798,.460,144,379,.380,223,419,.532,.550,203,221,.919,37,276,313,457,96,14,128,141,1081
397,Adreian Payne\paynead01,PF,26,ORL,5,0,43,7,10,.700,2,3,.667,5,7,.714,.800,5,6,.833,2,7,9,0,2,0,2,6,21
398,Cameron Payne\payneca01,PG,23,CHI,25,14,582,87,215,.405,35,91,.385,52,124,.419,.486,12,16,.750,18,51,69,113,26,9,36,44,221
399,Elfrid Payton\paytoel01,PG,23,TOT,63,63,1808,329,667,.493,30,92,.326,299,575,.520,.516,109,168,.649,64,210,274,393,83,22,168,147,797
399,Elfrid Payton\paytoel01,PG,23,ORL,44,44,1257,238,458,.520,25,67,.373,213,391,.545,.547,72,114,.632,47,127,174,275,64,16,114,97,573
399,Elfrid Payton\paytoel01,PG,23,PHO,19,19,551,91,209,.435,5,25,.200,86,184,.467,.447,37,54,.685,17,83,100,118,19,6,54,50,224
400,Gary Payton\paytoga02,PG,25,TOT,23,6,221,30,74,.405,6,25,.240,24,49,.490,.446,3,9,.333,13,31,44,21,7,3,7,30,69
400,Gary Payton\paytoga02,PG,25,MIL,12,6,106,13,33,.394,2,12,.167,11,21,.524,.424,2,3,.667,4,13,17,9,3,1,3,17,30
400,Gary Payton\paytoga02,PG,25,LAL,11,0,115,17,41,.415,4,13,.308,13,28,.464,.463,1,6,.167,9,18,27,12,4,2,4,13,39
401,Kendrick Perkins\perkike01,C,33,CLE,1,0,15,1,2,.500,0,0,,1,2,.500,.500,1,2,.500,0,1,1,2,1,0,1,1,3
402,London Perrantes\perralo01,PG,23,CLE,14,0,66,2,13,.154,0,3,.000,2,10,.200,.154,3,5,.600,1,3,4,5,2,1,1,6,7
403,Alec Peters\peteral01,PF,22,PHO,20,0,225,28,74,.378,18,58,.310,10,16,.625,.500,8,10,.800,8,29,37,12,2,2,4,13,82
404,Marshall Plumlee\plumlma02,C,25,MIL,8,0,52,1,3,.333,0,0,,1,3,.333,.333,12,16,.750,4,13,17,2,0,1,3,10,14
405,Mason Plumlee\plumlma01,C,27,DEN,74,26,1439,221,368,.601,0,1,.000,221,367,.602,.601,82,179,.458,132,268,400,142,49,81,103,184,524
406,Miles Plumlee\plumlmi01,C,29,ATL,55,35,918,105,180,.583,0,0,,105,180,.583,.583,27,60,.450,77,151,228,45,17,30,63,79,237
407,Jakob Poeltl\poeltja01,C,22,TOR,82,0,1524,253,384,.659,1,2,.500,252,382,.660,.660,60,101,.594,165,228,393,57,39,100,85,212,567
408,Quincy Pondexter\pondequ01,SF,29,CHI,23,1,196,14,49,.286,3,22,.136,11,27,.407,.316,14,17,.824,8,19,27,9,8,2,11,24,45
409,Otto Porter\porteot01,SF,24,WAS,77,77,2432,445,885,.503,138,313,.441,307,572,.537,.581,106,128,.828,103,389,492,157,116,41,75,151,1134
410,Bobby Portis\portibo01,PF,22,CHI,73,4,1643,382,811,.471,80,223,.359,302,588,.514,.520,120,156,.769,159,339,498,123,50,23,103,130,964
411,Kristaps Porzingis\porzikr01,PF,22,NYK,48,48,1553,390,889,.439,90,228,.395,300,661,.454,.489,218,275,.793,62,254,316,57,36,115,93,141,1088
412,Dwight Powell\poweldw01,C,26,DAL,79,25,1672,255,430,.593,28,84,.333,227,346,.656,.626,133,185,.719,135,309,444,91,67,32,59,186,671
413,Norman Powell\powelno01,SG,24,TOR,70,18,1062,150,374,.401,53,186,.285,97,188,.516,.472,32,39,.821,14,105,119,89,37,16,66,111,385
414,Alex Poythress\poythal01,PF,24,IND,25,0,104,11,26,.423,4,11,.364,7,15,.467,.500,0,0,,7,10,17,2,3,1,2,16,26
415,Jacob Pullen\pulleja01,PG,28,PHI,3,0,6,1,2,.500,0,1,.000,1,1,1.000,.500,0,0,,0,0,0,0,0,0,1,0,2
416,Rodney Purvis\purviro01,SG,23,ORL,16,2,290,35,107,.327,13,52,.250,22,55,.400,.388,13,15,.867,1,26,27,17,3,3,10,26,96
417,Zhou Qi\qizh01,C,22,HOU,18,0,124,6,32,.188,2,19,.105,4,13,.308,.219,8,12,.667,6,16,22,2,2,14,10,14,22
418,Tim Quarterman\quartti01,SG,23,HOU,3,0,13,1,3,.333,0,2,.000,1,1,1.000,.333,2,2,1.000,0,3,3,1,0,0,2,1,4
419,Ivan Rabb\rabbiv01,PF,20,MEM,36,5,516,86,152,.566,0,0,,86,152,.566,.566,29,36,.806,53,105,158,32,12,13,35,55,201
420,Julius Randle\randlju01,C,23,LAL,82,49,2190,504,904,.558,10,45,.222,494,859,.575,.563,305,425,.718,181,473,654,210,43,45,213,274,1323
421,Zach Randolph\randoza01,PF,36,SAC,59,57,1508,361,763,.473,51,147,.347,310,616,.503,.507,84,107,.785,97,300,397,127,42,10,116,119,857
422,Xavier Rathan-Mayes\rathaxa01,SG,23,MEM,5,0,118,12,42,.286,1,14,.071,11,28,.393,.298,4,9,.444,0,5,5,18,6,3,11,18,29
423,J.J. Redick\redicjj01,SG,33,PHI,70,70,2116,404,879,.460,193,460,.420,211,419,.504,.569,197,218,.904,9,169,178,210,35,6,103,123,1198
424,Davon Reed\reedda01,SG,22,PHO,21,1,242,22,76,.289,11,38,.289,11,38,.289,.362,8,12,.667,2,37,39,13,10,2,10,17,63
425,Willie Reed\reedwi02,C,27,TOT,42,5,428,81,121,.669,1,2,.500,80,119,.672,.674,32,55,.582,35,86,121,10,9,22,19,56,195
425,Willie Reed\reedwi02,C,27,LAC,39,5,419,80,120,.667,1,2,.500,79,118,.669,.671,32,55,.582,35,85,120,9,9,22,19,53,193
425,Willie Reed\reedwi02,C,27,DET,3,0,9,1,1,1.000,0,0,,1,1,1.000,1.000,0,0,,0,1,1,1,0,0,0,3,2
426,Josh Richardson\richajo01,SF,24,MIA,81,81,2689,399,885,.451,127,336,.378,272,549,.495,.523,120,142,.845,69,216,285,231,121,75,140,199,1045
427,Malachi Richardson\richama01,SG,22,TOT,26,4,324,30,90,.333,12,40,.300,18,50,.360,.400,17,22,.773,5,29,34,13,10,1,10,27,89
427,Malachi Richardson\richama01,SG,22,SAC,25,4,319,29,88,.330,12,39,.308,17,49,.347,.398,17,22,.773,5,28,33,13,10,1,10,27,87
427,Malachi Richardson\richama01,SG,22,TOR,1,0,5,1,2,.500,0,1,.000,1,1,1.000,.500,0,0,,0,1,1,0,0,0,0,0,2
428,Austin Rivers\riverau01,SG,25,LAC,61,59,2057,341,805,.424,136,360,.378,205,445,.461,.508,102,159,.642,27,118,145,242,74,16,109,152,920
429,Andre Roberson\roberan03,SG,26,OKC,39,39,1037,87,162,.537,8,36,.222,79,126,.627,.562,12,38,.316,75,110,185,46,45,35,30,89,194
430,Devin Robinson\robinde01,SF,22,WAS,1,0,13,1,3,.333,0,0,,1,3,.333,.333,0,0,,2,3,5,0,1,0,0,2,2
431,Glenn Robinson\robingl02,SF,24,IND,23,1,338,36,85,.424,14,34,.412,22,51,.431,.506,9,11,.818,11,26,37,17,13,1,5,14,95
432,Rajon Rondo\rondora01,PG,31,NOP,65,63,1705,231,494,.468,50,150,.333,181,344,.526,.518,25,46,.543,31,232,263,533,70,10,151,119,537
433,Derrick Rose\rosede01,PG,29,TOT,25,7,420,81,186,.435,7,30,.233,74,156,.474,.454,40,46,.870,13,22,35,37,7,4,35,16,209
433,Derrick Rose\rosede01,PG,29,CLE,16,7,308,58,132,.439,6,24,.250,52,108,.481,.462,35,41,.854,10,19,29,26,3,4,28,14,157
433,Derrick Rose\rosede01,PG,29,MIN,9,0,112,23,54,.426,1,6,.167,22,48,.458,.435,5,5,1.000,3,3,6,11,4,0,7,2,52
434,Terrence Ross\rosste01,SG,26,ORL,24,20,600,76,191,.398,30,93,.323,46,98,.469,.476,27,36,.750,10,63,73,38,27,11,29,45,209
435,Terry Rozier\roziete01,PG,23,BOS,80,16,2068,316,800,.395,153,402,.381,163,398,.410,.491,115,149,.772,63,313,376,232,80,19,80,123,900
436,Ricky Rubio\rubiori01,PG,27,UTA,77,77,2254,346,827,.418,96,273,.352,250,554,.451,.476,220,254,.866,44,307,351,410,121,11,207,206,1008
437,D'Angelo Russell\russeda01,PG,21,BRK,48,35,1234,278,672,.414,90,278,.324,188,394,.477,.481,97,131,.740,30,159,189,249,36,17,147,93,743
438,Domantas Sabonis\sabondo01,C,21,IND,74,19,1810,340,661,.514,13,37,.351,327,624,.524,.524,168,224,.750,165,407,572,151,40,32,137,220,861
439,JaKarr Sampson\sampsja02,SF,24,SAC,22,6,344,44,81,.543,5,10,.500,39,71,.549,.574,10,16,.625,21,57,78,9,8,22,8,48,103
440,Dario Saric\saricda01,PF,23,PHI,78,73,2310,403,890,.453,157,399,.393,246,491,.501,.541,178,207,.860,154,366,520,202,51,20,148,160,1141
441,Tomas Satoransky\satorto01,SG,26,WAS,73,30,1643,201,384,.523,47,101,.465,154,283,.544,.585,75,96,.781,72,161,233,286,52,15,83,131,524
442,Dennis Schroder\schrode01,PG,24,ATL,67,67,2078,500,1146,.436,76,262,.290,424,884,.480,.469,225,265,.849,44,164,208,417,72,6,183,147,1301
443,Mike Scott\scottmi01,PF,29,WAS,76,1,1406,276,524,.527,66,163,.405,210,361,.582,.590,50,76,.658,50,197,247,80,23,10,79,148,668
444,Thabo Sefolosha\sefolth01,SF,33,UTA,38,6,806,118,240,.492,32,84,.381,86,156,.551,.558,44,54,.815,29,132,161,33,52,12,30,59,312
445,Wayne Selden\seldewa01,SG,23,MEM,35,9,692,116,269,.431,49,122,.402,67,147,.456,.522,44,59,.746,16,40,56,66,18,5,54,59,325
446,Ramon Sessions\sessira01,PG,31,TOT,28,3,392,42,117,.359,8,26,.308,34,91,.374,.393,44,57,.772,6,32,38,77,14,2,30,29,136
446,Ramon Sessions\sessira01,PG,31,NYK,13,3,167,17,53,.321,2,11,.182,15,42,.357,.340,12,15,.800,1,17,18,27,7,1,15,14,48
446,Ramon Sessions\sessira01,PG,31,WAS,15,0,225,25,64,.391,6,15,.400,19,49,.388,.438,32,42,.762,5,15,20,50,7,1,15,15,88
447,Iman Shumpert\shumpim01,SG,27,CLE,14,6,276,22,58,.379,7,26,.269,15,32,.469,.440,11,15,.733,7,34,41,17,9,4,16,22,62
448,Pascal Siakam\siakapa01,PF,23,TOR,81,5,1679,253,498,.508,29,132,.220,224,366,.612,.537,54,87,.621,79,285,364,159,62,42,67,166,589
449,Xavier Silas\silasxa01,SG,30,BOS,2,0,7,0,3,.000,0,2,.000,0,1,.000,.000,0,0,,1,1,2,0,1,0,0,1,0
450,Ben Simmons\simmobe01,PG,21,PHI,81,81,2732,544,998,.545,0,11,.000,544,987,.551,.545,191,341,.560,145,514,659,661,140,70,278,211,1279
451,Jonathon Simmons\simmojo02,SG,28,ORL,69,50,2029,354,761,.465,69,204,.338,285,557,.512,.511,185,241,.768,61,178,239,171,58,16,146,175,962
452,Kobi Simmons\simmoko01,PG,20,MEM,32,12,643,80,189,.423,11,39,.282,69,150,.460,.452,25,25,1.000,14,36,50,68,18,5,44,61,196
453,Kyle Singler\singlky01,SF,29,OKC,12,0,59,7,21,.333,2,5,.400,5,16,.313,.381,7,13,.538,1,9,10,2,1,0,3,4,23
454,Marcus Smart\smartma01,SG,23,BOS,54,11,1614,189,515,.367,75,249,.301,114,266,.429,.440,97,133,.729,43,146,189,259,71,23,129,133,550
455,Dennis Smith\smithde03,PG,20,DAL,69,69,2049,404,1024,.395,106,339,.313,298,685,.435,.446,134,193,.694,50,210,260,358,71,18,194,152,1048
456,Ish Smith\smithis01,PG,29,DET,82,35,2043,389,801,.486,35,101,.347,354,700,.506,.507,81,116,.698,27,197,224,360,64,20,108,140,894
457,J.R. Smith\smithjr01,SG,32,CLE,80,61,2244,240,595,.403,143,381,.375,97,214,.453,.524,39,56,.696,29,206,235,141,68,11,81,161,662
458,Jason Smith\smithja02,C,31,WAS,33,2,285,45,115,.391,4,32,.125,41,83,.494,.409,19,21,.905,18,35,53,14,3,13,16,44,113
459,Josh Smith\smithjo03,PF,32,NOP,3,0,12,1,4,.250,0,0,,1,4,.250,.250,0,0,,3,1,4,0,0,0,0,3,2
460,Tony Snell\snellto01,SG,26,MIL,75,59,2053,185,425,.435,108,268,.403,77,157,.490,.562,38,48,.792,9,132,141,98,47,28,36,115,516
461,Marreese Speights\speigma01,C,30,ORL,52,3,675,138,349,.395,86,233,.369,52,116,.448,.519,40,55,.727,21,112,133,40,8,22,40,106,402
462,Nik Stauskas\stausni01,SG,24,TOT,41,0,523,60,154,.390,40,100,.400,20,54,.370,.519,21,29,.724,4,60,64,39,9,4,26,24,181
462,Nik Stauskas\stausni01,SG,24,PHI,6,0,45,1,4,.250,0,1,.000,1,3,.333,.250,2,2,1.000,0,1,1,1,4,0,4,3,4
462,Nik Stauskas\stausni01,SG,24,BRK,35,0,478,59,150,.393,40,99,.404,19,51,.373,.527,19,27,.704,4,59,63,38,5,4,22,21,177
463,Lance Stephenson\stephla01,SG,27,IND,82,7,1850,303,709,.427,67,232,.289,236,477,.495,.475,84,127,.661,62,362,424,235,46,17,131,177,757
464,David Stockton\stockda01,PG,26,UTA,3,0,9,2,3,.667,2,3,.667,0,0,,1.000,4,4,1.000,0,0,0,0,0,0,1,3,10
465,Julyan Stone\stoneju01,SG,29,CHO,23,0,175,6,13,.462,6,13,.462,0,0,,.692,1,2,.500,1,28,29,26,4,2,7,21,19
466,Edmond Sumner\sumneed01,PG,22,IND,1,0,2,1,1,1.000,0,0,,1,1,1.000,1.000,0,0,,0,1,1,0,0,0,0,1,2
467,Caleb Swanigan\swanica01,PF,20,POR,27,3,189,24,60,.400,1,8,.125,23,52,.442,.408,12,18,.667,15,39,54,14,5,3,18,37,61
468,Jayson Tatum\tatumja01,SF,19,BOS,80,80,2438,397,835,.475,105,242,.434,292,593,.492,.538,213,258,.826,50,352,402,128,83,58,114,170,1112
469,Isaiah Taylor\taylois01,PG,23,ATL,67,9,1167,163,390,.418,20,80,.250,143,310,.461,.444,99,141,.702,22,72,94,206,34,10,84,116,445
470,Jeff Teague\teaguje01,PG,29,MIN,70,70,2311,354,794,.446,84,228,.368,270,566,.477,.499,202,239,.845,24,185,209,492,102,23,177,171,994
471,Marquis Teague\teaguma01,PG,24,MEM,3,0,74,4,16,.250,1,4,.250,3,12,.250,.281,2,5,.400,1,5,6,13,4,0,3,5,11
472,Mirza Teletovic\teletmi01,PF,32,MIL,10,0,159,25,57,.439,21,45,.467,4,12,.333,.623,0,0,,3,20,23,10,4,1,7,14,71
473,Garrett Temple\templga01,SG,31,SAC,65,35,1615,199,476,.418,89,227,.392,110,249,.442,.512,60,78,.769,22,130,152,124,57,27,79,135,547
474,Milos Teodosic\teodomi01,PG,30,LAC,45,36,1134,151,360,.419,88,232,.379,63,128,.492,.542,39,46,.848,16,110,126,209,23,5,97,103,429
475,Jason Terry\terryja01,SG,40,MIL,51,4,814,59,154,.383,40,115,.348,19,39,.487,.513,8,9,.889,5,43,48,59,42,13,25,52,166
476,Daniel Theis\theisda01,C,25,BOS,63,3,936,126,233,.541,18,58,.310,108,175,.617,.579,61,81,.753,90,184,274,56,30,48,56,157,331
477,Isaiah Thomas\thomais02,PG,28,TOT,32,15,862,157,421,.373,55,188,.293,102,233,.438,.438,117,131,.893,17,50,67,153,15,3,95,58,486
477,Isaiah Thomas\thomais02,PG,28,CLE,15,14,406,70,194,.361,22,87,.253,48,107,.449,.418,59,68,.868,7,24,31,68,9,2,41,25,221
477,Isaiah Thomas\thomais02,PG,28,LAL,17,1,456,87,227,.383,33,101,.327,54,126,.429,.456,58,63,.921,10,26,36,85,6,1,54,33,265
478,Lance Thomas\thomala01,PF,29,NYK,73,31,1353,102,267,.382,50,124,.403,52,143,.364,.476,44,53,.830,44,131,175,44,30,14,40,134,298
479,Klay Thompson\thompkl01,SG,27,GSW,73,73,2506,575,1179,.488,229,521,.440,346,658,.526,.585,82,98,.837,31,246,277,185,55,34,128,117,1461
480,Tristan Thompson\thomptr01,C,26,CLE,53,22,1072,132,235,.562,0,0,,132,235,.562,.562,43,79,.544,126,226,352,33,16,17,36,102,307
481,Sindarius Thornwell\thornsi01,SG,23,LAC,73,17,1156,100,233,.429,23,61,.377,77,172,.448,.479,59,88,.670,33,107,140,68,48,25,53,125,282
482,Anthony Tolliver\tollian01,PF,32,DET,79,14,1757,219,472,.464,159,365,.436,60,107,.561,.632,106,133,.797,50,191,241,90,32,21,58,144,703
483,Karl-Anthony Towns\townska01,C,22,MIN,82,82,2918,639,1172,.545,120,285,.421,519,887,.585,.596,345,402,.858,238,774,1012,199,64,115,159,285,1743
484,P.J. Tucker\tuckepj01,PF,32,HOU,82,34,2281,172,441,.390,115,310,.371,57,131,.435,.520,43,60,.717,93,364,457,77,78,26,74,205,502
485,Evan Turner\turneev01,SF,29,POR,79,40,2034,258,577,.447,42,132,.318,216,445,.485,.484,91,107,.850,30,214,244,173,47,29,99,163,649
486,Myles Turner\turnemy01,C,21,IND,65,62,1836,306,639,.479,56,157,.357,250,482,.519,.523,160,206,.777,93,324,417,87,38,118,96,186,828
487,Ekpe Udoh\udohek01,C,30,UTA,63,3,810,60,120,.500,0,1,.000,60,119,.504,.500,42,56,.750,68,82,150,53,43,74,20,105,162
488,Tyler Ulis\ulisty01,PG,22,PHO,71,43,1658,214,551,.388,42,146,.288,172,405,.425,.426,84,101,.832,24,104,128,311,70,7,127,120,554
489,Jonas Valanciunas\valanjo01,C,25,TOR,77,77,1727,390,687,.568,30,74,.405,360,613,.587,.590,170,211,.806,183,477,660,81,29,69,115,192,980
490,Denzel Valentine\valende01,SG,24,CHI,77,37,2095,301,721,.417,143,370,.386,158,351,.450,.517,38,51,.745,48,345,393,244,65,11,99,185,783
491,Fred VanVleet\vanvlfr01,PG,23,TOR,76,0,1520,232,545,.426,108,261,.414,124,284,.437,.525,84,101,.832,25,159,184,243,68,19,74,130,656
492,Rashad Vaughn\vaughra01,SG,21,TOT,28,0,212,23,56,.411,14,37,.378,9,19,.474,.536,4,6,.667,3,18,21,13,5,3,6,15,64
492,Rashad Vaughn\vaughra01,SG,21,MIL,22,0,173,21,50,.420,13,35,.371,8,15,.533,.550,4,6,.667,2,15,17,12,4,3,4,12,59
492,Rashad Vaughn\vaughra01,SG,21,BRK,1,0,4,0,0,,0,0,,0,0,,,0,0,,0,0,0,1,0,0,0,1,0
492,Rashad Vaughn\vaughra01,SG,21,ORL,5,0,35,2,6,.333,1,2,.500,1,4,.250,.417,0,0,,1,3,4,0,1,0,2,2,5
493,Noah Vonleh\vonleno01,PF,22,TOT,54,16,875,104,234,.444,20,66,.303,84,168,.500,.487,36,58,.621,70,241,311,34,19,17,31,68,264
493,Noah Vonleh\vonleno01,PF,22,POR,33,12,476,47,96,.490,2,6,.333,45,90,.500,.500,23,31,.742,35,132,167,13,6,11,15,42,119
493,Noah Vonleh\vonleno01,PF,22,CHI,21,4,399,57,138,.413,18,60,.300,39,78,.500,.478,13,27,.481,35,109,144,21,13,6,16,26,145
494,Nikola Vucevic\vucevni01,C,27,ORL,57,57,1683,399,840,.475,64,204,.314,335,636,.527,.513,77,94,.819,101,422,523,191,56,62,109,144,939
495,Dwyane Wade\wadedw01,SG,36,TOT,67,3,1536,299,682,.438,32,111,.288,267,571,.468,.462,135,189,.714,50,202,252,228,61,47,140,124,765
495,Dwyane Wade\wadedw01,SG,36,CLE,46,3,1069,198,435,.455,23,70,.329,175,365,.479,.482,94,134,.701,39,142,181,163,42,32,92,84,513
495,Dwyane Wade\wadedw01,SG,36,MIA,21,0,467,101,247,.409,9,41,.220,92,206,.447,.427,41,55,.745,11,60,71,65,19,15,48,40,252
496,Dion Waiters\waitedi01,SG,26,MIA,30,30,918,163,410,.398,52,170,.306,111,240,.463,.461,51,69,.739,8,69,77,113,23,9,70,61,429
497,Kemba Walker\walkeke02,PG,27,CHO,80,80,2736,588,1363,.431,231,601,.384,357,762,.469,.516,363,420,.864,32,216,248,444,91,24,179,98,1770
498,John Wall\walljo01,PG,27,WAS,41,41,1410,280,667,.420,62,167,.371,218,500,.436,.466,175,241,.726,22,128,150,393,57,45,158,80,797
499,Tyrone Wallace\wallaty01,PG,23,LAC,30,19,851,110,247,.445,10,40,.250,100,207,.483,.466,61,78,.782,21,84,105,71,27,13,46,83,291
500,Taurean Waller-Prince\princta02,SF,23,ATL,82,82,2464,415,975,.426,176,457,.385,239,518,.461,.516,152,180,.844,50,339,389,214,85,42,191,168,1158
501,Derrick Walton\waltode01,PG,22,MIA,16,0,147,8,25,.320,7,17,.412,1,8,.125,.460,6,6,1.000,2,14,16,16,7,3,2,7,29
502,Jameel Warney\warneja01,PF,24,DAL,3,0,27,7,12,.583,0,0,,7,12,.583,.583,3,5,.600,4,5,9,0,0,0,1,2,17
503,T.J. Warren\warretj01,SF,24,PHO,65,65,2142,529,1063,.498,20,90,.222,509,973,.523,.507,193,255,.757,125,208,333,85,65,41,85,149,1271
504,Travis Wear\weartr01,SF,27,LAL,17,0,228,25,72,.347,17,47,.362,8,25,.320,.465,8,8,1.000,0,38,38,7,4,5,6,30,75
505,James Webb\webbja01,SF,24,BRK,10,0,120,6,24,.250,4,19,.211,2,5,.400,.333,0,0,,8,16,24,4,1,0,4,10,16
506,Briante Weber\weberbr01,PG,25,TOT,18,0,237,19,43,.442,4,11,.364,15,32,.469,.488,8,10,.800,8,27,35,22,18,5,15,28,50
506,Briante Weber\weberbr01,PG,25,HOU,13,0,118,9,22,.409,4,9,.444,5,13,.385,.500,4,4,1.000,3,15,18,13,10,3,7,18,26
506,Briante Weber\weberbr01,PG,25,MEM,5,0,119,10,21,.476,0,2,.000,10,19,.526,.476,4,6,.667,5,12,17,9,8,2,8,10,24
507,David West\westda01,C,37,GSW,73,0,999,216,378,.571,3,8,.375,213,370,.576,.575,60,79,.759,64,174,238,138,47,75,80,120,495
508,Russell Westbrook\westbru01,PG,29,OKC,80,80,2914,757,1687,.449,97,326,.298,660,1361,.485,.477,417,566,.737,152,652,804,820,147,20,381,200,2028
509,Andrew White\whitean01,SF,24,ATL,15,0,209,25,73,.342,18,49,.367,7,24,.292,.466,1,4,.250,4,30,34,6,3,1,8,12,69
510,Derrick White\whitede01,PG,23,SAS,17,0,139,16,33,.485,8,13,.615,8,20,.400,.606,14,20,.700,5,21,26,9,4,3,6,8,54
511,Okaro White\whiteok01,PF,25,MIA,6,4,80,7,16,.438,4,11,.364,3,5,.600,.563,2,3,.667,3,8,11,2,1,1,1,6,20
512,Isaiah Whitehead\whiteis01,PG,22,BRK,16,0,180,40,86,.465,7,18,.389,33,68,.485,.506,13,19,.684,4,22,26,20,8,2,24,23,100
513,Hassan Whiteside\whiteha01,C,28,MIA,54,54,1364,312,578,.540,2,2,1.000,310,576,.538,.542,128,182,.703,174,444,618,54,37,94,92,131,754
514,Andrew Wiggins\wiggian01,SF,22,MIN,82,82,2979,569,1300,.438,112,338,.331,457,962,.475,.481,202,314,.643,82,276,358,160,91,51,138,163,1452
515,Jacob Wiley\wileyja01,PF,23,BRK,5,0,33,1,4,.250,1,2,.500,0,2,.000,.375,1,2,.500,2,9,11,2,1,0,0,4,4
516,Damien Wilkins\wilkida02,SF,38,IND,19,1,152,13,39,.333,4,18,.222,9,21,.429,.385,3,4,.750,5,11,16,9,2,1,5,7,33
517,Alan Williams\willial03,PF,25,PHO,5,0,70,7,18,.389,0,0,,7,18,.389,.389,6,9,.667,3,19,22,8,5,1,7,13,20
518,C.J. Williams\willicj01,SG,27,LAC,38,17,707,87,197,.442,22,78,.282,65,119,.546,.497,13,16,.813,12,44,56,43,31,13,20,63,209
519,Derrick Williams\willide02,PF,26,LAL,2,0,9,1,4,.250,0,2,.000,1,2,.500,.250,0,0,,0,1,1,0,0,0,0,0,2
520,Lou Williams\willilo02,SG,31,LAC,79,19,2589,582,1337,.435,186,518,.359,396,819,.484,.505,432,491,.880,40,158,198,417,85,19,234,106,1782
521,Marvin Williams\willima02,PF,31,CHO,78,78,2006,258,563,.458,126,305,.413,132,258,.512,.570,102,123,.829,74,296,370,96,56,38,66,116,744
522,Matt Williams\willima05,SG,24,MIA,3,0,11,2,6,.333,1,5,.200,1,1,1.000,.417,0,0,,0,1,1,0,0,0,1,1,5
523,Troy Williams\willitr02,SF,23,TOT,21,1,307,51,109,.468,11,38,.289,40,71,.563,.518,20,30,.667,22,41,63,16,20,4,19,34,133
523,Troy Williams\willitr02,SF,23,HOU,4,0,17,2,9,.222,0,5,.000,2,4,.500,.222,1,3,.333,1,3,4,1,1,0,1,2,5
523,Troy Williams\willitr02,SF,23,NYK,17,1,290,49,100,.490,11,33,.333,38,67,.567,.545,19,27,.704,21,38,59,15,19,4,18,32,128
524,D.J. Wilson\wilsodj01,PF,21,MIL,22,0,71,9,16,.563,2,5,.400,7,11,.636,.625,1,2,.500,2,8,10,3,3,1,4,7,21
525,Jamil Wilson\wilsoja02,SF,27,LAC,15,10,274,38,81,.469,27,63,.429,11,18,.611,.636,2,4,.500,3,29,32,10,5,8,8,34,105
526,Justise Winslow\winslju01,PF,21,MIA,68,25,1680,207,488,.424,49,129,.380,158,359,.440,.474,66,104,.635,64,306,370,148,54,33,77,140,529
527,Jeff Withey\witheje01,C,27,DAL,9,0,39,6,16,.375,2,10,.200,4,6,.667,.438,1,2,.500,1,9,10,0,0,3,2,3,15
528,Nate Wolters\woltena01,PG,26,UTA,5,0,19,1,6,.167,0,0,,1,6,.167,.167,0,0,,1,1,2,1,0,0,0,1,2
529,Brandan Wright\wrighbr03,PF,30,TOT,28,1,381,59,102,.578,0,0,,59,102,.578,.578,21,33,.636,33,62,95,13,13,26,8,32,139
529,Brandan Wright\wrighbr03,PF,30,MEM,27,1,366,57,99,.576,0,0,,57,99,.576,.576,21,33,.636,32,61,93,13,13,25,8,29,135
529,Brandan Wright\wrighbr03,PF,30,HOU,1,0,15,2,3,.667,0,0,,2,3,.667,.667,0,0,,1,1,2,0,0,1,0,3,4
530,Delon Wright\wrighde01,PG,25,TOR,69,4,1433,201,432,.465,56,153,.366,145,279,.520,.530,97,117,.829,45,153,198,200,72,33,78,81,555
531,Guerschon Yabusele\yabusgu01,PF,22,BOS,33,4,235,26,61,.426,12,37,.324,14,24,.583,.525,15,22,.682,17,35,52,16,4,5,12,23,79
532,James Young\youngja01,SG,22,PHI,6,0,61,5,14,.357,3,10,.300,2,4,.500,.464,4,6,.667,0,2,2,2,0,0,1,4,17
533,Joe Young\youngjo01,PG,25,IND,53,1,558,80,186,.430,25,66,.379,55,120,.458,.497,22,29,.759,12,51,63,39,14,1,26,39,207
534,Nick Young\youngni01,SG,32,GSW,80,8,1393,201,488,.412,123,326,.377,78,162,.481,.538,56,65,.862,20,105,125,36,38,7,39,100,581
535,Thaddeus Young\youngth01,PF,29,IND,81,81,2607,421,864,.487,58,181,.320,363,683,.531,.521,55,92,.598,184,328,512,152,135,36,105,175,955
536,Cody Zeller\zelleco01,C,25,CHO,33,0,627,85,156,.545,2,3,.667,83,153,.542,.551,61,85,.718,67,110,177,31,14,21,33,81,233
537,Tyler Zeller\zellety01,C,28,TOT,66,34,1109,187,334,.560,10,28,.357,177,306,.578,.575,57,79,.722,110,195,305,47,15,35,47,126,441
537,Tyler Zeller\zellety01,C,28,BRK,42,33,703,125,229,.546,10,26,.385,115,203,.567,.568,40,60,.667,63,131,194,28,8,21,35,78,300
537,Tyler Zeller\zellety01,C,28,MIL,24,1,406,62,105,.590,0,2,.000,62,103,.602,.590,17,19,.895,47,64,111,19,7,14,12,48,141
538,Paul Zipser\zipsepa01,SF,23,CHI,54,12,824,81,234,.346,37,110,.336,44,124,.355,.425,19,25,.760,13,118,131,46,20,15,43,86,218
539,Ante Zizic\zizican01,C,21,CLE,32,2,214,49,67,.731,0,0,,49,67,.731,.731,21,29,.724,24,36,60,5,2,13,11,30,119
540,Ivica Zubac\zubaciv01,C,20,LAL,43,0,410,61,122,.500,0,1,.000,61,121,.504,.500,39,51,.765,45,78,123,25,8,15,26,47,161
