Rk,Player,Pos,Age,Tm,G,GS,MP,FG,FGA,FG%,3P,3PA,3P%,2P,2PA,2P%,eFG%,FT,FTA,FT%,ORB,DRB,TRB,AST,STL,BLK,TOV,PF,PTS
1,Alex Abrines\abrinal01,SG,25,OKC,31,2,588,56,157,.357,41,127,.323,15,30,.500,.487,12,13,.923,5,43,48,20,17,6,14,53,165
2,Quincy Acy\acyqu01,PF,28,PHO,10,0,123,4,18,.222,2,15,.133,2,3,.667,.278,7,10,.700,3,22,25,8,1,4,4,24,17
3,Jaylen Adams\adamsja01,PG,22,ATL,13,0,84,7,18,.389,6,12,.500,1,6,.167,.556,2,2,1.000,2,7,9,13,3,2,5,10,22
4,Steven Adams\adamsst01,C,25,OKC,58,58,1971,364,601,.606,0,1,.000,364,600,.607,.606,124,227,.546,263,282,545,97,92,44,96,148,852
5,Bam Adebayo\adebaba01,C,21,MIA,59,6,1289,172,305,.564,1,9,.111,171,296,.578,.566,118,162,.728,118,270,388,115,46,43,82,148,463
6,Deng Adel\adelde01,SF,21,CLE,12,3,158,9,30,.300,5,20,.250,4,10,.400,.383,2,2,1.000,2,11,13,4,1,4,5,11,25
7,DeVaughn Akoon-Purcell\akoonde01,SG,25,DEN,7,0,22,3,10,.300,0,4,.000,3,6,.500,.300,1,2,.500,1,3,4,6,2,0,2,4,7
8,LaMarcus Aldridge\aldrila01,C,33,SAS,61,61,1985,497,976,.509,5,25,.200,492,951,.517,.512,269,318,.846,190,353,543,153,31,76,114,136,1268
9,Rawle Alkins\alkinra01,SG,21,CHI,3,0,6,1,4,.250,1,1,1.000,0,3,.000,.375,0,0,,3,0,3,2,1,0,0,1,3
10,Grayson Allen\allengr01,SG,23,UTA,28,1,276,34,109,.312,19,69,.275,15,40,.375,.399,27,36,.750,1,10,11,17,4,3,16,30,114
11,Jarrett Allen\allenja01,C,20,BRK,60,60,1619,258,449,.575,6,39,.154,252,410,.615,.581,149,205,.727,152,370,522,90,35,95,82,139,671
12,Kadeem Allen\allenka01,SG,26,NYK,10,1,225,37,76,.487,8,16,.500,29,60,.483,.539,19,26,.731,5,24,29,45,8,1,11,26,101
13,Al-Farouq Aminu\aminual01,PF,28,POR,60,60,1742,190,432,.440,77,213,.362,113,219,.516,.529,112,131,.855,88,381,469,79,52,23,47,113,569
14,Justin Anderson\anderju01,SF,25,ATL,32,0,249,33,87,.379,8,40,.200,25,47,.532,.425,16,21,.762,11,34,45,12,11,7,13,28,90
15,Kyle Anderson\anderky01,SF,25,MEM,43,40,1281,150,276,.543,9,34,.265,141,242,.583,.560,37,64,.578,48,203,251,128,54,37,58,112,346
16,Ryan Anderson\anderry01,PF,30,TOT,18,8,290,21,62,.339,9,36,.250,12,26,.462,.411,11,14,.786,14,31,45,18,3,1,13,24,62
16,Ryan Anderson\anderry01,PF,30,PHO,15,8,278,19,60,.317,7,34,.206,12,26,.462,.375,11,14,.786,14,31,45,17,3,1,12,23,56
16,Ryan Anderson\anderry01,PF,30,MIA,3,0,12,2,2,1.000,2,2,1.000,0,0,,1.500,0,0,,0,0,0,1,0,0,1,1,6
17,Ike Anigbogu\anigbik01,C,20,IND,3,0,6,0,3,.000,0,0,,0,3,.000,.000,0,0,,1,2,3,1,0,1,1,0,0
18,Giannis Antetokounmpo\antetgi01,PF,24,MIL,55,55,1827,551,949,.581,33,136,.243,518,813,.637,.598,362,503,.720,127,569,696,330,77,80,211,184,1497
19,Carmelo Anthony\anthoca01,PF,34,HOU,10,2,294,49,121,.405,21,64,.328,28,57,.491,.492,15,22,.682,9,45,54,5,4,7,8,32,134
20,OG Anunoby\anunoog01,SF,21,TOR,51,6,1036,143,322,.444,57,164,.348,86,158,.544,.533,19,42,.452,39,117,156,34,33,12,36,109,362
21,Ryan Arcidiacono\arcidry01,PG,24,CHI,60,26,1479,113,272,.415,64,176,.364,49,96,.510,.533,51,56,.911,14,129,143,215,55,2,47,128,341
22,Trevor Ariza\arizatr01,SF,33,TOT,56,56,1984,243,615,.395,120,363,.331,123,252,.488,.493,100,126,.794,38,273,311,217,83,14,90,107,706
22,Trevor Ariza\arizatr01,SF,33,PHO,26,26,884,86,227,.379,50,139,.360,36,88,.409,.489,36,43,.837,16,129,145,87,38,8,39,44,258
22,Trevor Ariza\arizatr01,SF,33,WAS,30,30,1100,157,388,.405,70,224,.313,87,164,.530,.495,64,83,.771,22,144,166,130,45,6,51,63,448
23,D.J. Augustin\augusdj01,PG,31,ORL,61,61,1689,226,477,.474,101,229,.441,125,248,.504,.580,145,170,.853,31,109,140,303,35,1,95,87,698
24,Deandre Ayton\aytonde01,C,20,PHO,56,55,1732,403,685,.588,0,4,.000,403,681,.592,.588,112,148,.757,176,411,587,107,46,50,99,159,918
25,Dwayne Bacon\bacondw01,SG,23,CHO,25,0,265,44,84,.524,13,25,.520,31,59,.525,.601,10,12,.833,3,36,39,17,3,1,12,28,111
26,Marvin Bagley\baglema01,PF,19,SAC,46,2,1147,246,480,.513,16,60,.267,230,420,.548,.529,135,194,.696,112,219,331,46,27,47,76,96,643
27,Ron Baker\bakerro01,SG,25,TOT,15,0,152,4,20,.200,1,13,.077,3,7,.429,.225,5,6,.833,1,10,11,15,6,1,5,18,14
27,Ron Baker\bakerro01,SG,25,NYK,11,0,107,4,16,.250,1,9,.111,3,7,.429,.281,5,6,.833,1,6,7,13,5,0,3,16,14
27,Ron Baker\bakerro01,SG,25,WAS,4,0,45,0,4,.000,0,4,.000,0,0,,.000,0,0,,0,4,4,2,1,1,2,2,0
28,Wade Baldwin\baldwwa01,PG,22,POR,16,0,94,10,33,.303,2,9,.222,8,24,.333,.333,8,11,.727,2,13,15,12,1,2,14,11,30
29,Lonzo Ball\balllo01,PG,21,LAL,47,45,1423,185,456,.406,75,228,.329,110,228,.482,.488,20,48,.417,54,197,251,255,69,19,103,114,465
30,Mohamed Bamba\bambamo01,C,20,ORL,47,1,766,117,243,.481,21,70,.300,96,173,.555,.525,37,63,.587,64,169,233,39,13,64,43,102,292
31,J.J. Barea\bareajo01,PG,34,DAL,38,0,752,161,385,.418,38,128,.297,123,257,.479,.468,55,78,.705,13,82,95,211,22,1,72,50,415
32,Harrison Barnes\barneha02,PF-SF,26,TOT,55,55,1793,311,783,.397,128,341,.375,183,442,.414,.479,178,214,.832,43,202,245,77,41,11,74,90,928
32,Harrison Barnes\barneha02,PF,26,DAL,49,49,1584,290,717,.404,121,311,.389,169,406,.416,.489,165,198,.833,36,171,207,62,33,11,68,79,866
32,Harrison Barnes\barneha02,SF,26,SAC,6,6,209,21,66,.318,7,30,.233,14,36,.389,.371,13,16,.813,7,31,38,15,8,0,6,11,62
33,Will Barton\bartowi01,SG,28,DEN,21,16,564,93,223,.417,32,89,.360,61,134,.455,.489,35,43,.814,18,72,90,73,7,10,30,45,253
34,Keita Bates-Diop\bateske01,SF,23,MIN,8,0,61,7,17,.412,1,8,.125,6,9,.667,.441,2,5,.400,2,12,14,2,1,3,1,3,17
35,Nicolas Batum\batumni01,SF,30,CHO,60,60,1890,209,455,.459,92,234,.393,117,221,.529,.560,67,78,.859,55,259,314,203,59,33,96,110,577
36,Jerryd Bayless\bayleje01,PG,30,MIN,20,6,417,47,144,.326,23,71,.324,24,73,.329,.406,7,12,.583,7,31,38,75,11,1,19,35,124
37,Aron Baynes\baynear01,C,32,BOS,34,10,507,69,148,.466,16,48,.333,53,100,.530,.520,39,46,.848,60,87,147,38,6,22,28,82,193
38,Kent Bazemore\bazemke01,SG,29,ATL,47,33,1219,227,515,.441,70,213,.329,157,302,.520,.509,98,135,.726,24,157,181,110,74,38,96,126,622
39,Bradley Beal\bealbr01,SG,25,WAS,60,60,2241,563,1181,.477,152,434,.350,411,747,.550,.541,261,316,.826,68,235,303,324,84,45,170,180,1539
40,Malik Beasley\beaslma01,SG,22,DEN,60,17,1448,272,541,.503,126,288,.438,146,253,.577,.619,41,46,.891,26,126,152,75,40,6,38,97,711
41,Michael Beasley\beaslmi01,PF,30,LAL,26,2,277,75,153,.490,3,17,.176,72,136,.529,.500,28,39,.718,13,47,60,25,9,10,27,42,181
42,Marco Belinelli\belinma01,SG,32,SAS,60,1,1372,220,529,.416,118,308,.383,102,221,.462,.527,97,106,.915,13,132,145,112,28,8,54,93,655
43,Jordan Bell\belljo01,C,24,GSW,49,2,548,67,127,.528,0,1,.000,67,126,.532,.528,14,21,.667,39,89,128,56,18,38,24,61,148
44,DeAndre' Bembry\bembrde01,SG,24,ATL,61,15,1471,194,449,.432,38,131,.290,156,318,.491,.474,58,97,.598,33,220,253,152,74,33,106,145,484
45,Dragan Bender\bendedr01,PF,21,PHO,26,7,327,35,88,.398,8,49,.163,27,39,.692,.443,17,26,.654,16,60,76,21,5,3,18,30,95
46,Davis Bertans\bertada01,PF,26,SAS,56,12,1212,155,325,.477,113,240,.471,42,85,.494,.651,39,44,.886,20,175,195,69,29,28,33,96,462
47,Patrick Beverley\beverpa01,PG,30,LAC,62,33,1676,144,362,.398,82,214,.383,62,148,.419,.511,85,110,.773,54,245,299,224,49,35,66,216,455
48,Khem Birch\birchkh01,C,26,ORL,30,0,341,40,68,.588,0,1,.000,40,67,.597,.588,26,32,.813,34,67,101,21,11,20,11,35,106
49,Bismack Biyombo\biyombi01,C,26,CHO,34,17,499,54,94,.574,0,0,,54,94,.574,.574,42,62,.677,48,110,158,19,8,34,18,65,150
50,Nemanja Bjelica\bjeline01,PF,30,SAC,57,55,1316,212,439,.483,82,194,.423,130,245,.531,.576,52,68,.765,93,233,326,109,42,45,71,145,558
51,Antonio Blakeney\blakean01,SG,22,CHI,43,0,596,123,291,.423,33,72,.458,90,219,.411,.479,39,57,.684,6,61,67,24,10,8,25,26,318
52,Eric Bledsoe\bledser01,PG,29,MIL,59,59,1717,350,714,.490,89,282,.316,261,432,.604,.553,126,165,.764,59,207,266,315,85,22,123,124,915
53,Jaron Blossomgame\blossja01,SF,25,CLE,27,4,439,47,106,.443,10,39,.256,37,67,.552,.491,10,13,.769,26,72,98,13,7,8,11,20,114
54,Bogdan Bogdanovic\bogdabo01,SG,26,SAC,48,11,1343,260,614,.423,86,262,.328,174,352,.494,.493,98,120,.817,22,153,175,193,53,10,86,98,704
55,Bojan Bogdanovic\bogdabo02,SF,29,IND,61,61,1936,374,755,.495,121,285,.425,253,470,.538,.575,168,206,.816,28,216,244,112,50,0,97,108,1037
56,Jonah Bolden\boldejo01,PF,23,PHI,31,4,394,48,98,.490,17,55,.309,31,43,.721,.577,8,18,.444,28,82,110,21,9,28,27,66,121
57,Isaac Bonga\bongais01,PG,19,LAL,8,0,31,2,10,.200,0,2,.000,2,8,.250,.200,4,7,.571,3,3,6,6,3,0,2,3,8
58,Devin Booker\bookede01,SG,22,PHO,47,47,1635,405,887,.457,99,304,.326,306,583,.525,.512,248,291,.852,27,159,186,317,40,9,186,155,1157
59,Chris Boucher\bouchch01,PF,26,TOR,19,0,100,23,52,.442,10,27,.370,13,25,.520,.538,11,13,.846,12,18,30,0,3,18,2,18,67
60,Avery Bradley\bradlav01,SG,28,TOT,55,55,1640,199,496,.401,68,196,.347,131,300,.437,.470,26,32,.813,37,112,149,115,33,16,74,150,492
60,Avery Bradley\bradlav01,SG,28,LAC,49,49,1463,161,420,.383,58,172,.337,103,248,.415,.452,20,25,.800,35,96,131,96,27,16,61,133,400
60,Avery Bradley\bradlav01,SG,28,MEM,6,6,177,38,76,.500,10,24,.417,28,52,.538,.566,6,7,.857,2,16,18,19,6,0,13,17,92
61,Tony Bradley\bradlto01,C,21,UTA,1,0,9,0,3,.000,0,0,,0,3,.000,.000,0,0,,2,1,3,0,0,0,1,1,0
62,Corey Brewer\breweco01,SF,32,TOT,9,3,169,27,64,.422,8,23,.348,19,41,.463,.484,14,19,.737,4,15,19,11,12,2,9,23,76
62,Corey Brewer\breweco01,SF,32,PHI,7,3,140,20,49,.408,4,14,.286,16,35,.457,.449,9,13,.692,4,13,17,10,12,2,8,16,53
62,Corey Brewer\breweco01,SF,32,SAC,2,0,29,7,15,.467,4,9,.444,3,6,.500,.600,5,6,.833,0,2,2,1,0,0,1,7,23
63,Mikal Bridges\bridgmi01,SF,22,PHO,62,45,1735,178,416,.428,84,243,.346,94,173,.543,.529,60,77,.779,41,149,190,121,97,30,53,151,500
64,Miles Bridges\bridgmi02,SF,20,CHO,58,3,1109,148,331,.447,40,129,.310,108,202,.535,.508,46,62,.742,39,167,206,54,33,36,39,78,382
65,Isaiah Briscoe\briscis01,PG,22,ORL,35,0,475,45,114,.395,10,28,.357,35,86,.407,.439,13,24,.542,2,60,62,78,8,1,25,55,113
66,Ryan Broekhoff\broekry01,SG,28,DAL,28,0,222,29,65,.446,20,51,.392,9,14,.643,.600,2,2,1.000,3,25,28,15,2,3,5,15,80
67,Malcolm Brogdon\brogdma01,SG,26,MIL,56,56,1638,335,667,.502,89,213,.418,246,454,.542,.569,129,138,.935,58,207,265,188,41,12,84,89,888
68,Dillon Brooks\brookdi01,SF,23,MEM,18,0,330,49,122,.402,15,40,.375,34,82,.415,.463,22,30,.733,9,22,31,16,10,4,19,50,135
69,MarShon Brooks\brookma01,SG,30,MEM,29,0,387,76,169,.450,15,54,.278,61,115,.530,.494,23,33,.697,12,33,45,25,9,4,21,33,190
70,Bruce Brown\brownbr01,SG,22,DET,52,34,1045,96,249,.386,20,75,.267,76,174,.437,.426,33,48,.688,37,105,142,67,23,25,37,135,245
71,Jaylen Brown\brownja02,SG,22,BOS,56,23,1444,272,602,.452,67,207,.324,205,395,.519,.507,102,150,.680,53,190,243,78,56,27,78,149,713
72,Lorenzo Brown\brownlo01,PG,28,TOR,26,0,212,23,71,.324,6,28,.214,17,43,.395,.366,3,3,1.000,5,26,31,28,12,5,16,22,55
73,Sterling Brown\brownst02,SG,23,MIL,48,0,769,97,213,.455,40,111,.360,57,102,.559,.549,18,25,.720,24,110,134,60,19,5,32,65,252
74,Troy Brown\browntr01,SF,19,WAS,30,0,212,26,66,.394,4,16,.250,22,50,.440,.424,14,21,.667,5,34,39,29,8,1,8,17,70
75,Jalen Brunson\brunsja01,PG,22,DAL,52,18,963,146,334,.437,37,102,.363,109,232,.470,.493,45,65,.692,15,93,108,129,24,3,54,77,374
76,Thomas Bryant\bryanth01,C,21,WAS,50,43,964,202,318,.635,21,53,.396,181,265,.683,.668,64,80,.800,74,220,294,61,18,42,38,78,489
77,Reggie Bullock\bullore01,SG,27,TOT,49,49,1520,200,482,.415,127,323,.393,73,159,.459,.547,61,70,.871,21,116,137,120,29,9,58,89,588
77,Reggie Bullock\bullore01,SG,27,DET,44,44,1355,182,441,.413,114,294,.388,68,147,.463,.542,56,64,.875,20,103,123,109,24,5,54,79,534
77,Reggie Bullock\bullore01,SG,27,LAL,5,5,165,18,41,.439,13,29,.448,5,12,.417,.598,5,6,.833,1,13,14,11,5,4,4,10,54
78,Trey Burke\burketr01,PG,26,TOT,41,7,809,171,410,.417,37,104,.356,134,306,.438,.462,74,89,.831,21,57,78,109,28,5,37,41,453
78,Trey Burke\burketr01,PG,26,NYK,33,7,689,148,358,.413,30,86,.349,118,272,.434,.455,62,75,.827,15,47,62,94,21,5,29,33,388
78,Trey Burke\burketr01,PG,26,DAL,8,0,120,23,52,.442,7,18,.389,16,34,.471,.510,12,14,.857,6,10,16,15,7,0,8,8,65
79,Alec Burks\burksal01,SG,27,TOT,57,24,1320,188,465,.404,61,165,.370,127,300,.423,.470,116,141,.823,29,196,225,122,33,20,63,86,553
79,Alec Burks\burksal01,SG,27,UTA,17,0,269,47,114,.412,16,43,.372,31,71,.437,.482,33,38,.868,2,25,27,20,6,4,15,22,143
79,Alec Burks\burksal01,SG,27,CLE,34,24,979,136,340,.400,45,119,.378,91,221,.412,.466,79,98,.806,26,160,186,98,25,16,46,62,396
79,Alec Burks\burksal01,SG,27,SAC,6,0,72,5,11,.455,0,3,.000,5,8,.625,.455,4,5,.800,1,11,12,4,2,0,2,2,14
80,Deonte Burton\burtode02,SG,25,OKC,22,0,197,28,64,.438,7,21,.333,21,43,.488,.492,6,8,.750,3,19,22,7,5,8,9,27,69
81,Jimmy Butler\butleji01,SF-SG,29,TOT,49,49,1640,325,682,.477,56,157,.357,269,525,.512,.518,228,264,.864,83,165,248,195,97,30,69,82,934
81,Jimmy Butler\butleji01,SG,29,MIN,10,10,361,74,157,.471,17,45,.378,57,112,.509,.525,48,61,.787,16,36,52,43,24,10,14,18,213
81,Jimmy Butler\butleji01,SF,29,PHI,39,39,1279,251,525,.478,39,112,.348,212,413,.513,.515,180,203,.887,67,129,196,152,73,20,55,64,721
82,Bruno Caboclo\cabocbr01,SF,23,MEM,14,2,279,29,76,.382,14,49,.286,15,27,.556,.474,14,14,1.000,12,34,46,12,6,16,10,37,86
83,Jose Calderon\caldejo01,PG,37,DET,46,0,621,45,118,.381,14,56,.250,31,62,.500,.441,9,11,.818,9,47,56,113,16,3,35,63,113
84,Kentavious Caldwell-Pope\caldwke01,SG,25,LAL,60,12,1423,206,480,.429,95,277,.343,111,203,.547,.528,94,110,.855,34,129,163,65,53,9,43,96,601
85,Isaiah Canaan\canaais01,PG,27,TOT,27,16,610,64,160,.400,34,93,.366,30,67,.448,.506,19,24,.792,5,50,55,83,14,1,33,50,181
85,Isaiah Canaan\canaais01,PG,27,PHO,19,15,503,51,129,.395,25,72,.347,26,57,.456,.492,15,20,.750,5,44,49,62,12,0,29,46,142
85,Isaiah Canaan\canaais01,PG,27,MIN,7,1,95,11,29,.379,7,19,.368,4,10,.400,.500,4,4,1.000,0,5,5,19,2,1,4,4,33
85,Isaiah Canaan\canaais01,PG,27,MIL,1,0,12,2,2,1.000,2,2,1.000,0,0,,1.500,0,0,,0,1,1,2,0,0,0,0,6
86,Clint Capela\capelca01,C,24,HOU,45,45,1531,331,524,.632,0,0,,331,524,.632,.632,109,174,.626,213,349,562,62,26,80,68,121,771
87,DeMarre Carroll\carrode01,SF,32,BRK,49,0,1261,162,422,.384,75,221,.339,87,201,.433,.473,141,188,.750,52,209,261,65,25,7,55,79,540
88,Jevon Carter\carteje01,PG,23,MEM,26,3,384,26,108,.241,13,56,.232,13,52,.250,.301,8,13,.615,5,30,35,45,21,8,22,40,73
89,Vince Carter\cartevi01,SF,42,ATL,56,8,873,132,306,.431,79,202,.391,53,104,.510,.560,27,40,.675,23,118,141,52,30,17,37,99,370
90,Wendell Carter\cartewe01,C,19,CHI,44,44,1110,180,371,.485,6,32,.188,174,339,.513,.493,89,112,.795,87,220,307,78,26,58,65,152,455
91,Michael Carter-Williams\cartemi01,PG,27,HOU,16,1,145,25,61,.410,7,19,.368,18,42,.429,.467,12,26,.462,3,10,13,21,9,6,10,27,69
92,Alex Caruso\carusal01,PG,24,LAL,6,0,21,2,4,.500,1,1,1.000,1,3,.333,.625,1,4,.250,1,0,1,1,0,2,0,3,6
93,Omri Casspi\casspom01,SF,30,MEM,36,0,520,86,161,.534,15,43,.349,71,118,.602,.581,39,58,.672,17,98,115,26,20,9,23,35,226
94,Willie Cauley-Stein\caulewi01,C,25,SAC,60,60,1671,319,590,.541,1,2,.500,318,588,.541,.542,109,200,.545,142,360,502,151,76,39,71,184,748
95,Troy Caupain\caupatr01,PG,23,ORL,2,0,9,2,4,.500,1,2,.500,1,2,.500,.625,0,0,,0,2,2,3,1,0,0,0,5
96,Tyler Cavanaugh\cavanty01,PF,24,UTA,8,0,19,2,6,.333,0,3,.000,2,3,.667,.333,2,2,1.000,1,3,4,0,0,0,1,0,6
97,Tyson Chandler\chandty01,C,36,TOT,51,6,839,59,97,.608,0,1,.000,59,96,.615,.608,48,81,.593,91,205,296,37,21,22,39,106,166
97,Tyson Chandler\chandty01,C,36,PHO,7,0,89,8,12,.667,0,0,,8,12,.667,.667,10,18,.556,7,32,39,6,2,1,7,21,26
97,Tyson Chandler\chandty01,C,36,LAL,44,6,750,51,85,.600,0,1,.000,51,84,.607,.600,38,63,.603,84,173,257,31,19,21,32,85,140
98,Wilson Chandler\chandwi01,PF,31,PHI,36,32,951,91,207,.440,46,118,.390,45,89,.506,.551,13,18,.722,44,124,168,72,22,18,39,94,241
99,Joe Chealey\chealjo01,PG,23,CHO,1,0,8,1,3,.333,0,0,,1,3,.333,.333,0,0,,0,0,0,1,0,0,0,1,2
100,Marquese Chriss\chrisma01,PF,21,TOT,23,1,242,38,91,.418,13,42,.310,25,49,.510,.489,15,20,.750,18,45,63,11,7,6,18,43,104
100,Marquese Chriss\chrisma01,PF,21,HOU,16,0,104,11,34,.324,1,15,.067,10,19,.526,.338,6,7,.857,7,21,28,6,2,4,12,17,29
100,Marquese Chriss\chrisma01,PF,21,CLE,7,1,138,27,57,.474,12,27,.444,15,30,.500,.579,9,13,.692,11,24,35,5,5,2,6,26,75
101,Gary Clark\clarkga01,PF,24,HOU,37,1,528,35,110,.318,29,100,.290,6,10,.600,.450,6,6,1.000,18,76,94,14,15,22,5,38,105
102,Ian Clark\clarkia01,SG,27,NOP,43,0,574,79,193,.409,34,98,.347,45,95,.474,.497,15,16,.938,6,48,54,49,10,4,38,57,207
103,Jordan Clarkson\clarkjo01,SG,26,CLE,60,0,1616,398,894,.445,112,338,.331,286,556,.514,.508,111,133,.835,62,145,207,147,43,12,105,87,1019
104,John Collins\collijo01,PF,21,ATL,45,43,1345,336,592,.568,42,112,.375,294,480,.613,.603,147,193,.762,160,271,431,90,14,18,92,147,861
105,Zach Collins\colliza01,C,21,POR,59,0,1052,144,303,.475,30,89,.337,114,214,.533,.525,76,98,.776,82,166,248,56,22,48,58,143,394
106,Darren Collison\collida01,PG,31,IND,61,61,1715,242,511,.474,65,156,.417,177,355,.499,.537,108,129,.837,28,152,180,364,87,8,97,109,657
107,Bonzie Colson\colsobo01,SF,23,MIL,1,0,3,0,1,.000,0,1,.000,0,0,,.000,0,0,,0,0,0,0,0,0,0,0,0
108,Mike Conley\conlemi01,PG,31,MEM,59,59,1973,400,933,.429,125,357,.350,275,576,.477,.496,265,313,.847,38,164,202,375,83,20,113,97,1190
109,Pat Connaughton\connapa01,SG,26,MIL,39,1,670,88,204,.431,34,118,.288,54,86,.628,.515,15,22,.682,29,98,127,73,17,15,19,41,225
110,Quinn Cook\cookqu01,PG,25,GSW,52,8,723,135,305,.443,51,136,.375,84,169,.497,.526,15,20,.750,17,95,112,83,17,3,33,68,336
111,DeMarcus Cousins\couside01,C,28,GSW,14,14,342,69,157,.439,12,42,.286,57,115,.496,.478,57,73,.781,19,91,110,49,18,20,32,52,207
112,Robert Covington\covinro01,SF,28,TOT,35,35,1203,156,362,.431,85,225,.378,71,137,.518,.548,68,89,.764,28,165,193,46,74,47,47,126,465
112,Robert Covington\covinro01,SF,28,PHI,13,13,440,50,117,.427,30,77,.390,20,40,.500,.556,17,23,.739,7,60,67,14,24,23,22,45,147
112,Robert Covington\covinro01,SF,28,MIN,22,22,763,106,245,.433,55,148,.372,51,97,.526,.545,51,66,.773,21,105,126,32,50,24,25,81,318
113,Allen Crabbe\crabbal01,SG,26,BRK,35,15,910,116,313,.371,85,216,.394,31,97,.320,.506,36,48,.750,15,103,118,37,20,11,39,81,353
114,Torrey Craig\craigto01,SF,28,DEN,54,37,1186,122,282,.433,41,140,.293,81,142,.570,.505,33,51,.647,73,134,207,51,31,35,39,133,318
115,Jamal Crawford\crawfja01,SG,38,PHO,51,0,899,115,310,.371,42,142,.296,73,168,.435,.439,62,75,.827,7,56,63,169,24,10,76,60,334
116,Mitch Creek\creekmi01,SF,26,BRK,4,0,36,5,10,.500,0,1,.000,5,9,.556,.500,5,7,.714,5,5,10,5,1,0,0,3,15
117,Jae Crowder\crowdja01,SF,28,UTA,58,8,1601,232,583,.398,130,385,.338,102,198,.515,.509,111,159,.698,47,229,276,95,44,23,66,121,705
118,Dante Cunningham\cunnida01,PF,31,SAS,55,21,863,74,146,.507,30,61,.492,44,85,.518,.610,13,16,.813,46,135,181,48,24,13,21,67,191
119,Seth Curry\curryse01,SG,28,POR,54,2,932,127,283,.449,72,152,.474,55,131,.420,.576,17,19,.895,17,57,74,53,20,8,38,74,343
120,Stephen Curry\curryst01,PG,30,GSW,49,49,1683,466,960,.485,255,572,.446,211,388,.544,.618,206,224,.920,32,224,256,260,63,19,138,123,1393
121,Troy Daniels\danietr01,SG,27,PHO,31,0,405,64,150,.427,43,109,.394,21,41,.512,.570,13,17,.765,6,27,33,12,17,2,19,40,184
122,Anthony Davis\davisan02,C,25,NOP,47,47,1658,465,913,.509,41,129,.318,424,784,.541,.532,328,409,.802,148,445,593,195,76,118,91,118,1299
123,Ed Davis\davised01,C,29,BRK,61,1,1121,149,239,.623,0,2,.000,149,237,.629,.623,72,120,.600,172,357,529,51,29,27,53,173,370
124,Tyler Davis\davisty01,C,21,OKC,1,0,1,0,1,.000,0,0,,0,1,.000,.000,0,0,,1,0,1,0,0,0,0,0,0
125,Dewayne Dedmon\dedmode01,C,29,ATL,51,40,1276,204,418,.488,65,171,.380,139,247,.563,.566,75,88,.852,84,279,363,70,51,58,73,173,548
126,Sam Dekker\dekkesa01,SF-PF,24,TOT,36,5,599,99,199,.497,13,42,.310,86,157,.548,.530,18,30,.600,41,80,121,33,31,7,17,36,229
126,Sam Dekker\dekkesa01,PF,24,CLE,9,5,169,22,48,.458,5,13,.385,17,35,.486,.510,8,10,.800,9,24,33,9,11,0,5,13,57
126,Sam Dekker\dekkesa01,SF,24,WAS,27,0,430,77,151,.510,8,29,.276,69,122,.566,.536,10,20,.500,32,56,88,24,20,7,12,23,172
127,Angel Delgado\delgaan01,C,24,LAC,1,0,14,1,4,.250,0,0,,1,4,.250,.250,1,2,.500,2,2,4,0,1,0,0,2,3
128,Matthew Dellavedova\dellama01,PG,28,TOT,44,0,741,91,219,.416,41,118,.347,50,101,.495,.509,40,50,.800,5,67,72,170,12,2,64,69,263
128,Matthew Dellavedova\dellama01,PG,28,MIL,12,0,97,6,19,.316,4,11,.364,2,8,.250,.421,4,4,1.000,0,10,10,29,2,0,11,9,20
128,Matthew Dellavedova\dellama01,PG,28,CLE,32,0,644,85,200,.425,37,107,.346,48,93,.516,.518,36,46,.783,5,57,62,141,10,2,53,60,243
129,Luol Deng\denglu01,SF,33,MIN,21,2,384,59,117,.504,14,43,.326,45,74,.608,.564,25,35,.714,19,53,72,18,14,8,14,23,157
130,DeMar DeRozan\derozde01,SG,29,SAS,57,57,2007,475,1014,.468,7,41,.171,468,973,.481,.472,276,333,.829,42,307,349,345,58,28,149,134,1233
131,Marcus Derrickson\derrima01,PF,22,GSW,9,0,54,10,24,.417,5,14,.357,5,10,.500,.521,3,4,.750,5,3,8,1,0,1,3,9,28
132,Cheick Diallo\diallch01,PF,22,NOP,44,0,521,94,147,.639,0,2,.000,94,145,.648,.639,37,51,.725,46,144,190,15,18,26,30,62,225
133,Hamidou Diallo\diallha01,SG,20,OKC,45,3,515,75,161,.466,4,23,.174,71,138,.514,.478,36,59,.610,37,57,94,17,20,10,23,75,190
134,Gorgui Dieng\dienggo01,C,29,MIN,57,0,762,124,251,.494,13,42,.310,111,209,.531,.520,58,66,.879,59,174,233,50,31,29,35,107,319
135,Spencer Dinwiddie\dinwisp01,PG,25,BRK,49,4,1399,275,596,.461,96,262,.366,179,334,.536,.542,198,249,.795,21,100,121,246,28,11,114,136,844
136,Donte DiVincenzo\divindo01,SG,22,MIL,23,0,358,42,107,.393,17,69,.246,25,38,.658,.472,9,11,.818,13,43,56,27,12,6,18,34,110
137,Luka Doncic\doncilu01,SG,19,DAL,56,56,1805,384,889,.432,138,391,.353,246,498,.494,.510,262,361,.726,62,343,405,317,57,16,187,104,1168
138,Tyler Dorsey\dorsety01,SG,22,TOT,29,0,269,37,97,.381,12,43,.279,25,54,.463,.443,17,28,.607,12,36,48,18,7,1,11,22,103
138,Tyler Dorsey\dorsety01,SG,22,ATL,27,0,251,32,89,.360,10,39,.256,22,50,.440,.416,16,26,.615,9,34,43,17,7,1,10,20,90
138,Tyler Dorsey\dorsety01,SG,22,MEM,2,0,18,5,8,.625,2,4,.500,3,4,.750,.750,1,2,.500,3,2,5,1,0,0,1,2,13
139,Damyean Dotson\dotsoda01,SG,24,NYK,52,19,1299,190,448,.424,82,212,.387,108,236,.458,.516,48,67,.716,29,151,180,75,44,7,38,93,510
140,PJ Dozier\doziepj01,SG,22,BOS,4,0,10,3,6,.500,1,2,.500,2,4,.500,.583,0,0,,2,2,4,0,0,0,0,1,7
141,Goran Dragic\dragigo01,PG,32,MIA,16,14,446,84,206,.408,22,74,.297,62,132,.470,.461,38,50,.760,8,35,43,72,10,4,38,34,228
142,Andre Drummond\drumman01,C,25,DET,56,56,1856,411,773,.532,4,33,.121,407,740,.550,.534,161,286,.563,289,557,846,65,94,99,128,191,987
143,Jared Dudley\dudleja01,PF,33,BRK,44,25,951,77,190,.405,39,121,.322,38,69,.551,.508,22,35,.629,25,95,120,65,28,13,37,105,215
144,Kris Dunn\dunnkr01,PG,24,CHI,33,31,1024,158,366,.432,19,60,.317,139,306,.454,.458,40,51,.784,10,125,135,207,47,16,82,117,375
145,Kevin Durant\duranke01,PF,30,GSW,60,60,2127,582,1128,.516,113,307,.368,469,821,.571,.566,373,418,.892,32,386,418,347,47,71,182,118,1650
146,Trevon Duval\duvaltr01,PG,20,MIL,3,0,6,2,3,.667,1,1,1.000,1,2,.500,.833,0,0,,0,1,1,2,0,0,0,0,5
147,Vince Edwards\edwarvi01,SF,22,HOU,2,0,16,1,4,.250,1,4,.250,0,0,,.375,0,0,,1,1,2,0,0,0,0,0,3
148,Henry Ellenson\ellenhe01,PF,22,TOT,4,0,65,9,22,.409,5,11,.455,4,11,.364,.523,2,2,1.000,0,18,18,6,2,0,1,4,25
148,Henry Ellenson\ellenhe01,PF,22,DET,2,0,25,4,10,.400,2,4,.500,2,6,.333,.500,2,2,1.000,0,9,9,1,0,0,0,2,12
148,Henry Ellenson\ellenhe01,PF,22,NYK,2,0,40,5,12,.417,3,7,.429,2,5,.400,.542,0,0,,0,9,9,5,2,0,1,2,13
149,Wayne Ellington\ellinwa01,SG,31,TOT,30,15,672,84,230,.365,69,196,.352,15,34,.441,.515,16,19,.842,6,54,60,34,27,3,18,52,253
149,Wayne Ellington\ellinwa01,SG,31,MIA,25,12,533,69,184,.375,57,155,.368,12,29,.414,.530,14,16,.875,6,41,47,29,24,3,14,40,209
149,Wayne Ellington\ellinwa01,SG,31,DET,5,3,139,15,46,.326,12,41,.293,3,5,.600,.457,2,3,.667,0,13,13,5,3,0,4,12,44
150,Joel Embiid\embiijo01,C,24,PHI,54,54,1822,483,1002,.482,64,217,.295,419,785,.534,.514,443,546,.811,134,594,728,188,32,105,194,182,1473
151,James Ennis\ennisja01,SF,28,TOT,45,25,1004,107,225,.476,46,127,.362,61,98,.622,.578,44,60,.733,37,85,122,31,39,16,25,117,304
151,James Ennis\ennisja01,SF,28,HOU,40,25,949,104,211,.493,44,120,.367,60,91,.659,.597,42,58,.724,37,80,117,27,38,16,23,111,294
151,James Ennis\ennisja01,SF,28,PHI,5,0,55,3,14,.214,2,7,.286,1,7,.143,.286,2,2,1.000,0,5,5,4,1,0,2,6,10
152,Drew Eubanks\eubandr01,PF,21,SAS,15,0,73,14,19,.737,0,0,,14,19,.737,.737,9,11,.818,1,15,16,3,1,2,4,7,37
153,Jacob Evans\evansja02,SG,21,GSW,23,0,99,6,25,.240,1,6,.167,5,19,.263,.260,0,1,.000,1,8,9,13,1,1,6,13,13
154,Jawun Evans\evansja01,PG,22,PHO,7,0,64,3,13,.231,0,2,.000,3,11,.273,.231,0,0,,1,11,12,10,3,0,6,8,6
155,Tyreke Evans\evansty01,SG,29,IND,54,15,1088,198,511,.387,64,178,.360,134,333,.402,.450,89,117,.761,27,120,147,130,52,15,93,90,549
156,Dante Exum\exumda01,PG,23,UTA,39,1,637,101,234,.432,18,59,.305,83,175,.474,.470,68,86,.791,15,50,65,107,14,5,46,63,288
157,Kenneth Faried\farieke01,C,29,TOT,27,13,557,122,203,.601,7,18,.389,115,185,.622,.618,47,76,.618,78,115,193,18,12,19,25,59,298
157,Kenneth Faried\farieke01,C,29,BRK,12,0,118,25,42,.595,1,5,.200,24,37,.649,.607,10,16,.625,15,29,44,2,2,4,6,8,61
157,Kenneth Faried\farieke01,C,29,HOU,15,13,439,97,161,.602,6,13,.462,91,148,.615,.621,37,60,.617,63,86,149,16,10,15,19,51,237
158,Derrick Favors\favorde01,C,27,UTA,58,52,1348,260,453,.574,14,64,.219,246,389,.632,.589,113,171,.661,151,265,416,62,42,80,63,124,647
159,Cristiano Felicio\feliccr01,C,26,CHI,39,0,401,50,93,.538,0,2,.000,50,91,.549,.538,25,37,.676,37,72,109,19,5,4,17,37,125
160,Raymond Felton\feltora01,PG,34,OKC,19,0,224,37,93,.398,10,39,.256,27,54,.500,.452,10,11,.909,3,20,23,35,8,4,11,18,94
161,Terrance Ferguson\fergute01,SG,20,OKC,52,52,1275,132,302,.437,74,195,.379,58,107,.542,.560,19,30,.633,24,66,90,42,30,12,27,167,357
162,Yogi Ferrell\ferreyo01,PG,25,SAC,50,3,751,108,247,.437,38,104,.365,70,143,.490,.514,41,47,.872,11,70,81,101,27,4,23,39,295
163,Dorian Finney-Smith\finnedo01,SF,25,DAL,60,21,1532,177,389,.455,61,183,.333,116,206,.563,.533,57,84,.679,105,190,295,56,60,29,60,141,472
164,Bryn Forbes\forbebr01,PG,25,SAS,62,61,1771,274,627,.437,130,323,.402,144,304,.474,.541,61,67,.910,14,165,179,137,37,3,67,133,739
165,Evan Fournier\fournev01,SG,26,ORL,61,61,1930,347,809,.429,116,353,.329,231,456,.507,.501,105,132,.795,30,160,190,226,55,9,124,176,915
166,De'Aaron Fox\foxde01,PG,21,SAC,59,59,1858,367,804,.456,65,174,.374,302,630,.479,.497,222,307,.723,34,180,214,423,100,32,176,151,1021
167,Melvin Frazier\frazime01,SG,22,ORL,7,0,32,6,14,.429,0,3,.000,6,11,.545,.429,0,0,,2,1,3,0,1,0,1,4,12
168,Tim Frazier\fraziti01,PG,28,NOP,47,17,909,88,195,.451,27,77,.351,61,118,.517,.521,32,41,.780,32,105,137,206,25,4,60,93,235
169,Channing Frye\fryech01,C,35,CLE,29,5,275,32,89,.360,24,60,.400,8,29,.276,.494,9,12,.750,4,39,43,16,5,4,10,35,97
170,Markelle Fultz\fultzma01,PG,20,PHI,19,15,427,65,155,.419,4,14,.286,61,141,.433,.432,21,37,.568,26,44,70,59,17,5,25,52,155
171,Danilo Gallinari\gallida01,SF,30,LAC,51,51,1558,289,641,.451,123,281,.438,166,360,.461,.547,260,286,.909,42,259,301,124,37,18,74,101,961
172,Langston Galloway\gallola01,SG,27,DET,57,4,1191,155,404,.384,89,265,.336,66,139,.475,.494,48,59,.814,34,95,129,59,26,5,18,88,447
173,Marc Gasol\gasolma01,C,34,TOT,59,54,1912,326,732,.445,79,225,.351,247,507,.487,.499,158,213,.742,64,426,490,272,65,68,127,162,889
173,Marc Gasol\gasolma01,C,34,MEM,53,53,1788,303,683,.444,76,221,.344,227,462,.491,.499,152,201,.756,56,399,455,248,60,63,119,147,834
173,Marc Gasol\gasolma01,C,34,TOR,6,1,124,23,49,.469,3,4,.750,20,45,.444,.500,6,12,.500,8,27,35,24,5,5,8,15,55
174,Pau Gasol\gasolpa01,C,38,SAS,27,6,330,41,88,.466,5,10,.500,36,78,.462,.494,27,38,.711,22,105,127,50,5,14,14,28,114
175,Rudy Gay\gayru01,PF,32,SAS,51,47,1380,291,563,.517,57,133,.429,234,430,.544,.567,90,105,.857,47,281,328,131,43,30,84,127,729
176,Paul George\georgpa01,SF,28,OKC,59,59,2163,557,1243,.448,228,573,.398,329,670,.491,.540,347,411,.844,82,396,478,251,135,26,153,165,1689
177,Taj Gibson\gibsota01,PF,33,MIN,59,56,1475,256,458,.559,11,33,.333,245,425,.576,.571,107,141,.759,146,241,387,69,47,33,64,159,630
178,Harry Giles\gilesha01,PF,20,SAC,47,0,616,124,250,.496,0,5,.000,124,245,.506,.496,45,70,.643,50,119,169,61,26,15,56,125,293
179,Shai Gilgeous-Alexander\gilgesh01,PG,20,LAC,62,53,1586,230,506,.455,30,97,.309,200,409,.489,.484,113,140,.807,42,124,166,186,68,35,115,124,603
180,Rudy Gobert\goberru01,C,26,UTA,59,58,1877,333,509,.654,0,0,,333,509,.654,.654,241,365,.660,223,539,762,130,53,128,95,166,907
181,Brandon Goodwin\goodwbr01,PG,23,DEN,16,0,57,6,23,.261,2,6,.333,4,17,.235,.304,9,11,.818,1,2,3,14,0,0,3,7,23
182,Aaron Gordon\gordoaa01,PF,23,ORL,58,58,1935,341,768,.444,86,257,.335,255,511,.499,.500,149,206,.723,95,326,421,207,43,40,118,136,917
183,Eric Gordon\gordoer01,SG,30,HOU,48,33,1562,272,696,.391,135,417,.324,137,279,.491,.488,102,127,.803,15,105,120,101,29,21,70,107,781
184,Marcin Gortat\gortama01,C,34,LAC,47,43,751,99,186,.532,0,0,,99,186,.532,.532,35,48,.729,67,194,261,65,6,24,50,92,233
185,Devonte' Graham\grahade01,PG,23,CHO,31,3,403,48,130,.369,23,75,.307,25,55,.455,.458,16,22,.727,3,34,37,68,17,2,21,31,135
186,Treveon Graham\grahatr01,SG,25,BRK,23,17,510,42,127,.331,23,84,.274,19,43,.442,.421,14,18,.778,16,50,66,24,8,5,14,54,121
187,Jerami Grant\grantje01,PF,24,OKC,58,55,1877,289,554,.522,70,181,.387,219,373,.587,.585,118,169,.698,60,237,297,55,52,80,47,155,766
188,Jerian Grant\grantje02,PG,26,ORL,50,1,831,75,186,.403,30,90,.333,45,96,.469,.484,23,34,.676,17,69,86,139,40,5,46,68,203
189,Donte Grantham\grantdo01,SF,23,OKC,1,0,2,0,1,.000,0,1,.000,0,0,,.000,0,0,,0,0,0,0,0,0,0,0,0
190,Danny Green\greenda02,SG,31,TOR,60,60,1707,214,478,.448,137,319,.429,77,159,.484,.591,28,31,.903,50,198,248,85,53,43,54,139,593
191,Draymond Green\greendr01,PF,28,GSW,45,45,1400,126,291,.433,28,113,.248,98,178,.551,.481,46,65,.708,43,293,336,328,67,47,118,143,326
192,Gerald Green\greenge01,SG,33,HOU,56,0,1185,191,460,.415,124,350,.354,67,110,.609,.550,39,49,.796,26,120,146,34,21,23,43,107,545
193,JaMychal Green\greenja01,PF,28,TOT,47,4,1017,169,346,.488,48,116,.414,121,230,.526,.558,69,88,.784,78,214,292,39,38,30,70,140,455
193,JaMychal Green\greenja01,PF,28,MEM,41,4,900,151,312,.484,38,96,.396,113,216,.523,.545,63,80,.788,72,180,252,36,33,26,64,123,403
193,JaMychal Green\greenja01,PF,28,LAC,6,0,117,18,34,.529,10,20,.500,8,14,.571,.676,6,8,.750,6,34,40,3,5,4,6,17,52
194,Jeff Green\greenje02,PF,32,WAS,58,32,1611,248,526,.471,89,244,.365,159,282,.564,.556,134,149,.899,51,204,255,117,28,31,78,125,719
195,Blake Griffin\griffbl01,PF,29,DET,57,57,2050,499,1052,.474,143,391,.366,356,661,.539,.542,332,444,.748,78,377,455,309,40,23,209,160,1473
196,Daniel Hamilton\hamilda02,SG,23,ATL,19,3,204,23,60,.383,8,23,.348,15,37,.405,.450,3,6,.500,10,37,47,22,6,1,16,19,57
197,Tim Hardaway\hardati02,SG,26,TOT,54,53,1732,329,839,.392,136,397,.343,193,442,.437,.473,218,258,.845,30,158,188,139,48,7,94,119,1012
197,Tim Hardaway\hardati02,SG,26,NYK,46,46,1499,282,726,.388,117,337,.347,165,389,.424,.469,199,233,.854,26,135,161,122,42,6,81,106,880
197,Tim Hardaway\hardati02,SG,26,DAL,8,7,233,47,113,.416,19,60,.317,28,53,.528,.500,19,25,.760,4,23,27,17,6,1,13,13,132
198,James Harden\hardeja01,SG,29,HOU,56,56,2092,599,1361,.440,276,753,.367,323,608,.531,.542,560,643,.871,53,318,371,427,119,42,304,183,2034
199,Maurice Harkless\harklma01,SF,25,POR,40,33,868,105,225,.467,23,77,.299,82,148,.554,.518,23,34,.676,45,116,161,37,39,34,29,110,256
200,Montrezl Harrell\harremo01,C,25,LAC,62,4,1628,406,646,.628,1,11,.091,405,635,.638,.629,195,311,.627,142,262,404,115,56,87,90,192,1008
201,Devin Harris\harride01,PG,35,DAL,48,0,722,95,233,.408,41,134,.306,54,99,.545,.496,68,89,.764,7,67,74,67,29,11,37,85,299
202,Gary Harris\harriga01,SG,24,DEN,35,27,1021,181,427,.424,53,167,.317,128,260,.492,.486,85,106,.802,22,81,103,90,35,14,42,76,500
203,Joe Harris\harrijo01,SG,27,BRK,57,57,1718,287,567,.506,140,293,.478,147,274,.536,.630,81,95,.853,37,167,204,147,29,11,87,146,795
204,Tobias Harris\harrito02,PF-SF,26,TOT,62,62,2144,478,954,.501,128,301,.425,350,653,.536,.568,211,243,.868,42,447,489,168,42,30,117,140,1295
204,Tobias Harris\harrito02,PF,26,LAC,55,55,1903,424,855,.496,112,258,.434,312,597,.523,.561,192,219,.877,37,395,432,150,40,24,109,123,1152
204,Tobias Harris\harrito02,SF,26,PHI,7,7,241,54,99,.545,16,43,.372,38,56,.679,.626,19,24,.792,5,52,57,18,2,6,8,17,143
205,Andrew Harrison\harrian01,SG-PG,24,TOT,17,0,187,16,53,.302,5,25,.200,11,28,.393,.349,17,18,.944,6,14,20,24,4,2,12,34,54
205,Andrew Harrison\harrian01,PG,24,MEM,1,0,5,1,2,.500,0,1,.000,1,1,1.000,.500,0,0,,0,0,0,0,0,0,0,1,2
205,Andrew Harrison\harrian01,SG,24,CLE,10,0,144,12,39,.308,3,14,.214,9,25,.360,.346,16,16,1.000,4,11,15,17,4,2,10,26,43
205,Andrew Harrison\harrian01,SG,24,NOP,6,0,38,3,12,.250,2,10,.200,1,2,.500,.333,1,2,.500,2,3,5,7,0,0,2,7,9
206,Shaquille Harrison\harrish01,PG,25,CHI,52,0,896,99,249,.398,17,65,.262,82,184,.446,.432,52,82,.634,17,118,135,86,62,19,38,82,267
207,Josh Hart\hartjo01,SG,23,LAL,57,21,1479,167,411,.406,81,243,.333,86,168,.512,.505,49,72,.681,32,190,222,82,57,35,55,130,464
208,Isaiah Hartenstein\harteis01,PF,20,HOU,27,0,220,20,41,.488,2,6,.333,18,35,.514,.512,11,14,.786,21,26,47,14,7,12,13,56,53
209,Udonis Haslem\hasleud01,C,38,MIA,4,0,15,2,6,.333,0,2,.000,2,4,.500,.333,0,0,,1,5,6,0,0,0,2,3,4
210,Gordon Hayward\haywago01,PF,28,BOS,55,17,1426,214,493,.434,65,196,.332,149,297,.502,.500,114,133,.857,44,204,248,190,51,19,81,81,607
211,John Henson\hensojo01,C,28,MIL,14,0,188,31,67,.463,11,31,.355,20,36,.556,.545,6,10,.600,16,55,71,14,7,11,12,16,79
212,Juan Hernangomez\hernaju01,PF,23,DEN,56,25,1239,133,291,.457,64,165,.388,69,126,.548,.567,64,84,.762,62,186,248,48,24,22,34,78,394
213,Willy Hernangomez\hernawi01,C,24,CHO,45,2,617,120,233,.515,13,30,.433,107,203,.527,.543,75,111,.676,91,158,249,41,11,15,45,79,328
214,Mario Hezonja\hezonma01,SF,23,NYK,48,14,916,140,353,.397,33,119,.277,107,234,.457,.443,54,77,.701,21,156,177,49,45,6,56,83,367
215,Isaiah Hicks\hicksis01,PF,24,NYK,1,0,4,0,0,,0,0,,0,0,,,1,2,.500,0,0,0,1,0,0,0,0,1
216,Buddy Hield\hieldbu01,SG,26,SAC,60,60,1897,461,970,.475,203,453,.448,258,517,.499,.580,114,134,.851,80,232,312,138,33,23,118,145,1239
217,Haywood Highsmith\highsha01,SF,22,PHI,2,0,9,1,2,.500,1,2,.500,0,0,,.750,0,0,,0,1,1,2,0,0,0,0,3
218,Nene Hilario\hilarne01,C,36,HOU,30,2,402,46,82,.561,0,2,.000,46,80,.575,.561,26,35,.743,23,67,90,19,15,12,7,63,118
219,George Hill\hillge01,PG,32,TOT,47,13,1037,125,282,.443,37,114,.325,88,168,.524,.509,47,57,.825,30,85,115,110,43,7,40,81,334
219,George Hill\hillge01,PG,32,CLE,13,13,344,55,107,.514,13,28,.464,42,79,.532,.575,17,20,.850,12,15,27,36,12,1,20,35,140
219,George Hill\hillge01,PG,32,MIL,34,0,693,70,175,.400,24,86,.279,46,89,.517,.469,30,37,.811,18,70,88,74,31,6,20,46,194
220,Solomon Hill\hillso01,SF,27,NOP,35,15,712,50,129,.388,20,70,.286,30,59,.508,.465,19,27,.704,30,78,108,44,18,8,23,61,139
221,Aaron Holiday\holidaa01,PG,22,IND,37,0,438,73,191,.382,28,95,.295,45,96,.469,.455,30,34,.882,4,50,54,56,15,12,26,47,204
222,Jrue Holiday\holidjr01,SG,28,NOP,62,62,2237,500,1063,.470,106,329,.322,394,734,.537,.520,199,260,.765,74,240,314,487,101,53,192,136,1305
223,Justin Holiday\holidju01,SG,29,TOT,62,57,2010,221,596,.371,124,366,.339,97,230,.422,.475,65,73,.890,29,225,254,123,91,28,80,120,631
223,Justin Holiday\holidju01,SG,29,CHI,38,38,1325,151,394,.383,97,270,.359,54,124,.435,.506,41,46,.891,19,150,169,85,67,21,47,79,440
223,Justin Holiday\holidju01,SG,29,MEM,24,19,685,70,202,.347,27,96,.281,43,106,.406,.413,24,27,.889,10,75,85,38,24,7,33,41,191
224,John Holland\hollajo02,SF,30,CLE,1,0,1,0,0,,0,0,,0,0,,,0,0,,0,0,0,0,0,0,0,0,0
225,Rondae Hollis-Jefferson\holliro01,SF,24,BRK,49,21,1091,169,417,.405,9,45,.200,160,372,.430,.416,102,157,.650,67,195,262,82,34,23,55,94,449
226,Richaun Holmes\holmeri01,C,25,PHO,56,2,925,177,273,.648,0,0,,177,273,.648,.648,92,128,.719,92,162,254,47,31,64,42,152,446
227,Rodney Hood\hoodro01,SG,26,TOT,52,45,1385,216,499,.433,62,170,.365,154,329,.468,.495,105,117,.897,19,103,122,98,44,7,37,113,599
227,Rodney Hood\hoodro01,SG,26,CLE,45,45,1234,194,454,.427,55,152,.362,139,302,.460,.488,104,114,.912,18,94,112,92,38,5,36,101,547
227,Rodney Hood\hoodro01,SG,26,POR,7,0,151,22,45,.489,7,18,.389,15,27,.556,.567,1,3,.333,1,9,10,6,6,2,1,12,52
228,Al Horford\horfoal01,C,32,BOS,51,51,1462,279,535,.521,58,162,.358,221,373,.592,.576,43,54,.796,98,251,349,204,45,73,77,97,659
229,Danuel House\houseda01,SF,25,HOU,25,12,620,71,155,.458,39,100,.390,32,55,.582,.584,45,55,.818,20,69,89,26,14,10,23,45,226
230,Dwight Howard\howardw01,C,33,WAS,9,9,230,43,69,.623,0,0,,43,69,.623,.623,29,48,.604,24,59,83,4,7,4,16,34,115
231,Kevin Huerter\huertke01,SG,20,ATL,55,39,1496,188,447,.421,96,247,.389,92,200,.460,.528,35,47,.745,41,136,177,153,48,19,87,111,507
232,Chandler Hutchison\hutchch01,SF,22,CHI,44,14,895,96,209,.459,14,50,.280,82,159,.516,.493,23,38,.605,31,154,185,34,23,6,25,59,229
233,Serge Ibaka\ibakase01,C,29,TOR,58,48,1659,382,726,.526,38,141,.270,344,585,.588,.552,117,151,.775,124,337,461,87,27,73,98,177,919
234,Andre Iguodala\iguodan01,SF,35,GSW,53,11,1259,122,247,.494,41,117,.350,81,130,.623,.577,35,60,.583,36,167,203,174,47,43,39,74,320
235,Ersan Ilyasova\ilyaser01,PF,31,MIL,48,4,852,119,266,.447,41,111,.369,78,155,.503,.524,38,44,.864,71,145,216,41,26,11,36,122,317
236,Joe Ingles\inglejo01,SF,31,UTA,59,59,1852,252,571,.441,126,333,.378,126,238,.529,.552,69,96,.719,20,206,226,295,79,12,131,140,699
237,Brandon Ingram\ingrabr01,SF,21,LAL,49,49,1642,331,675,.490,28,87,.322,303,588,.515,.511,181,270,.670,39,207,246,147,28,29,126,137,871
238,Kyrie Irving\irvinky01,PG,26,BOS,50,50,1635,446,904,.493,127,308,.412,319,596,.535,.564,155,178,.871,58,180,238,345,81,24,130,116,1174
239,Jonathan Isaac\isaacjo01,PF,21,ORL,56,45,1473,186,439,.424,55,178,.309,131,261,.502,.486,91,107,.850,68,230,298,54,46,76,58,111,518
240,Wesley Iwundu\iwundwe01,SF,24,ORL,48,12,832,79,194,.407,19,55,.345,60,139,.432,.456,62,78,.795,25,96,121,41,20,18,31,92,239
241,Demetrius Jackson\jacksde01,PG,24,PHI,6,0,39,8,15,.533,2,6,.333,6,9,.667,.600,4,4,1.000,2,1,3,5,2,0,1,4,22
242,Frank Jackson\jacksfr01,PG,20,NOP,47,7,739,109,266,.410,28,102,.275,81,164,.494,.462,33,44,.750,17,66,83,44,16,1,29,65,279
243,Jaren Jackson\jacksja02,PF,19,MEM,58,56,1515,298,589,.506,51,142,.359,247,447,.553,.549,151,197,.766,73,199,272,64,52,82,98,220,798
244,Josh Jackson\jacksjo02,SG,21,PHO,62,25,1497,266,640,.416,47,162,.290,219,478,.458,.452,108,161,.671,53,206,259,144,63,39,143,162,687
245,Justin Jackson\jacksju01,SF,23,TOT,59,3,1156,136,325,.418,59,172,.343,77,153,.503,.509,44,53,.830,26,127,153,71,24,13,23,71,375
245,Justin Jackson\jacksju01,SF,23,SAC,52,3,1083,125,295,.424,55,159,.346,70,136,.515,.517,41,50,.820,25,121,146,68,23,13,22,67,346
245,Justin Jackson\jacksju01,SF,23,DAL,7,0,73,11,30,.367,4,13,.308,7,17,.412,.433,3,3,1.000,1,6,7,3,1,0,1,4,29
246,Reggie Jackson\jacksre01,PG,28,DET,59,59,1712,306,736,.416,121,335,.361,185,401,.461,.498,160,182,.879,34,128,162,262,41,6,105,164,893
247,LeBron James\jamesle01,SF,34,LAL,42,42,1481,413,810,.510,84,242,.347,329,568,.579,.562,214,316,.677,44,324,368,327,60,27,148,69,1124
248,Amile Jefferson\jeffeam01,PF,25,ORL,5,0,20,1,4,.250,0,0,,1,4,.250,.250,4,4,1.000,2,5,7,0,1,0,0,3,6
249,John Jenkins\jenkijo01,SG,27,TOT,9,0,92,15,30,.500,6,15,.400,9,15,.600,.600,2,3,.667,2,7,9,5,0,0,2,0,38
249,John Jenkins\jenkijo01,SG,27,WAS,4,0,14,2,2,1.000,2,2,1.000,0,0,,1.500,0,0,,0,1,1,1,0,0,0,0,6
249,John Jenkins\jenkijo01,SG,27,NYK,5,0,78,13,28,.464,4,13,.308,9,15,.600,.536,2,3,.667,2,6,8,4,0,0,2,0,32
250,Jonas Jerebko\jerebjo01,PF,31,GSW,55,6,986,131,279,.470,54,152,.355,77,127,.606,.566,51,62,.823,64,187,251,80,17,11,36,110,367
251,Alize Johnson\johnsal02,PF,22,IND,11,0,32,2,10,.200,1,2,.500,1,8,.125,.250,1,4,.250,1,7,8,0,0,1,0,3,6
252,Amir Johnson\johnsam01,C,31,PHI,38,2,358,56,105,.533,9,25,.360,47,80,.588,.576,23,30,.767,26,69,95,45,11,8,33,74,144
253,James Johnson\johnsja01,PF,31,MIA,41,33,854,124,289,.429,38,108,.352,86,181,.475,.495,34,47,.723,16,114,130,95,27,19,54,83,320
254,Stanley Johnson\johnsst04,SF,22,TOT,54,7,1038,141,376,.375,52,190,.274,89,186,.478,.444,41,52,.788,31,159,190,67,51,13,62,102,375
254,Stanley Johnson\johnsst04,SF,22,DET,48,7,961,133,349,.381,51,181,.282,82,168,.488,.454,41,51,.804,25,150,175,60,48,13,55,92,358
254,Stanley Johnson\johnsst04,SF,22,NOP,6,0,77,8,27,.296,1,9,.111,7,18,.389,.315,0,1,.000,6,9,15,7,3,0,7,10,17
255,Tyler Johnson\johnsty01,PG-SG,26,TOT,50,15,1308,194,463,.419,82,230,.357,112,233,.481,.508,74,103,.718,25,120,145,135,49,24,69,87,544
255,Tyler Johnson\johnsty01,PG,26,MIA,44,10,1123,171,401,.426,72,204,.353,99,197,.503,.516,61,88,.693,19,102,121,112,40,21,63,72,475
255,Tyler Johnson\johnsty01,SG,26,PHO,6,5,185,23,62,.371,10,26,.385,13,36,.361,.452,13,15,.867,6,18,24,23,9,3,6,15,69
256,Wesley Johnson\johnswe01,SF,31,TOT,32,13,485,43,112,.384,23,66,.348,20,46,.435,.487,10,16,.625,12,54,66,22,14,11,17,57,119
256,Wesley Johnson\johnswe01,SF,31,NOP,26,13,377,35,88,.398,19,50,.380,16,38,.421,.506,6,9,.667,10,44,54,16,12,7,12,45,95
256,Wesley Johnson\johnswe01,SF,31,WAS,6,0,108,8,24,.333,4,16,.250,4,8,.500,.417,4,7,.571,2,10,12,6,2,4,5,12,24
257,Nikola Jokic\jokicni01,C,23,DEN,59,59,1860,457,909,.503,67,212,.316,390,697,.560,.540,238,282,.844,166,467,633,454,83,38,191,169,1219
258,Damian Jones\jonesda03,C,23,GSW,24,22,410,53,74,.716,0,0,,53,74,.716,.716,24,37,.649,31,44,75,28,12,25,16,63,130
259,Derrick Jones\jonesde02,SF,21,MIA,39,5,712,109,214,.509,20,56,.357,89,158,.563,.556,47,75,.627,69,96,165,19,31,28,25,77,285
260,Jalen Jones\jonesja04,SF,25,CLE,16,0,214,26,62,.419,10,28,.357,16,34,.471,.500,19,27,.704,11,23,34,7,9,2,8,27,81
261,Tyus Jones\jonesty01,PG,22,MIN,46,7,950,102,260,.392,23,80,.288,79,180,.439,.437,36,44,.818,13,66,79,188,61,4,30,48,263
262,DeAndre Jordan\jordade01,C,30,TOT,58,58,1768,243,375,.648,0,0,,243,375,.648,.648,159,231,.688,189,593,782,116,36,63,124,145,645
262,DeAndre Jordan\jordade01,C,30,DAL,50,50,1554,208,323,.644,0,0,,208,323,.644,.644,135,198,.682,161,525,686,99,33,53,111,125,551
262,DeAndre Jordan\jordade01,C,30,NYK,8,8,214,35,52,.673,0,0,,35,52,.673,.673,24,33,.727,28,68,96,17,3,10,13,20,94
263,Cory Joseph\josepco01,PG,27,IND,61,3,1557,185,419,.442,46,140,.329,139,279,.498,.496,21,32,.656,29,192,221,238,63,12,67,94,437
264,Frank Kaminsky\kaminfr01,C,25,CHO,26,0,281,49,102,.480,16,46,.348,33,56,.589,.559,22,35,.629,19,43,62,27,5,5,18,26,136
265,Enes Kanter\kanteen01,C,26,TOT,47,23,1187,268,496,.540,7,23,.304,261,473,.552,.547,114,139,.820,180,304,484,90,19,17,83,115,657
265,Enes Kanter\kanteen01,C,26,NYK,44,23,1128,251,468,.536,7,22,.318,244,446,.547,.544,105,129,.814,171,290,461,84,18,17,79,106,614
265,Enes Kanter\kanteen01,C,26,POR,3,0,59,17,28,.607,0,1,.000,17,27,.630,.607,9,10,.900,9,14,23,6,1,0,4,9,43
266,Luke Kennard\kennalu01,SG,22,DET,41,10,867,136,315,.432,62,160,.388,74,155,.477,.530,29,38,.763,8,109,117,60,18,8,33,57,363
267,Michael Kidd-Gilchrist\kiddgmi01,PF,25,CHO,53,1,1039,145,302,.480,11,40,.275,134,262,.511,.498,92,119,.773,83,138,221,49,27,37,40,137,393
268,George King\kingge03,SF,25,PHO,1,0,6,0,0,,0,0,,0,0,,,0,0,,0,1,1,0,0,0,0,0,0
269,Maxi Kleber\klebima01,PF,27,DAL,54,16,1064,128,285,.449,55,165,.333,73,120,.608,.546,41,52,.788,62,152,214,43,28,63,40,105,352
270,Brandon Knight\knighbr03,PG,27,TOT,18,5,221,26,80,.325,12,52,.231,14,28,.500,.400,13,15,.867,2,16,18,27,4,0,11,20,77
270,Brandon Knight\knighbr03,PG,27,HOU,12,0,118,11,47,.234,5,32,.156,6,15,.400,.287,9,11,.818,1,8,9,9,2,0,5,14,36
270,Brandon Knight\knighbr03,PG,27,CLE,6,5,103,15,33,.455,7,20,.350,8,13,.615,.561,4,4,1.000,1,8,9,18,2,0,6,6,41
271,Kevin Knox\knoxke01,PF,19,NYK,54,36,1535,241,666,.362,89,266,.335,152,400,.380,.429,109,149,.732,45,194,239,53,29,17,83,131,680
272,Furkan Korkmaz\korkmfu01,SG,21,PHI,46,6,654,94,234,.402,46,139,.331,48,95,.505,.500,35,42,.833,16,89,105,51,28,2,25,59,269
273,Luke Kornet\kornelu01,PF,23,NYK,31,12,476,69,180,.383,47,121,.388,22,59,.373,.514,23,27,.852,16,60,76,34,20,17,17,27,208
274,Kyle Korver\korveky01,SG-PF,37,TOT,53,0,980,151,346,.436,100,245,.408,51,101,.505,.581,51,61,.836,6,111,117,53,15,10,47,75,453
274,Kyle Korver\korveky01,PF,37,CLE,16,0,251,35,76,.461,25,54,.463,10,22,.455,.625,13,16,.813,0,29,29,17,3,2,17,22,108
274,Kyle Korver\korveky01,SG,37,UTA,37,0,729,116,270,.430,75,191,.393,41,79,.519,.569,38,45,.844,6,82,88,36,12,8,30,53,345
275,Kosta Koufos\koufoko01,C,29,SAC,32,1,381,53,109,.486,0,0,,53,109,.486,.486,6,17,.353,40,99,139,26,13,13,20,54,112
276,Rodions Kurucs\kurucro01,SF,20,BRK,43,29,877,142,307,.463,34,112,.304,108,195,.554,.518,52,59,.881,40,115,155,33,26,12,51,99,370
277,Kyle Kuzma\kuzmaky01,PF,23,LAL,56,54,1836,407,867,.469,109,341,.320,298,526,.567,.532,147,193,.762,48,267,315,138,35,20,111,129,1070
278,Skal Labissiere\labissk01,PF,22,TOT,15,0,117,13,30,.433,4,11,.364,9,19,.474,.500,6,11,.545,4,21,25,6,2,4,8,22,36
278,Skal Labissiere\labissk01,PF,22,SAC,13,0,113,13,30,.433,4,11,.364,9,19,.474,.500,6,11,.545,4,20,24,6,2,3,7,21,36
278,Skal Labissiere\labissk01,PF,22,POR,2,0,4,0,0,,0,0,,0,0,,,0,0,,0,1,1,0,0,1,1,1,0
279,Jeremy Lamb\lambje01,SG,26,CHO,57,54,1617,312,706,.442,75,227,.330,237,479,.495,.495,156,181,.862,48,265,313,117,61,17,55,105,855
280,Zach LaVine\lavinza01,SG,23,CHI,54,53,1842,444,959,.463,100,273,.366,344,686,.501,.515,259,302,.858,30,217,247,242,50,22,177,120,1247
281,Jake Layman\laymaja01,SF,24,POR,49,25,908,159,296,.537,47,128,.367,112,168,.667,.617,29,40,.725,44,108,152,35,23,23,31,67,394
282,T.J. Leaf\leaftj01,PF,21,IND,40,0,335,58,110,.527,5,24,.208,53,86,.616,.550,9,16,.563,22,52,74,16,4,10,10,26,130
283,Courtney Lee\leeco01,SG,33,TOT,18,2,212,25,58,.431,6,20,.300,19,38,.500,.483,12,17,.706,6,24,30,20,10,2,6,20,68
283,Courtney Lee\leeco01,SG,33,NYK,12,2,160,21,47,.447,5,16,.313,16,31,.516,.500,9,14,.643,6,21,27,16,8,2,5,13,56
283,Courtney Lee\leeco01,SG,33,DAL,6,0,52,4,11,.364,1,4,.250,3,7,.429,.409,3,3,1.000,0,3,3,4,2,0,1,7,12
284,Damion Lee\leeda03,SG,26,GSW,18,0,215,32,71,.451,15,37,.405,17,34,.500,.556,12,15,.800,6,30,36,3,8,0,8,19,91
285,Alex Len\lenal01,C,25,ATL,57,20,1073,208,430,.484,34,104,.327,174,326,.534,.523,106,155,.684,117,194,311,56,21,51,82,142,556
286,Kawhi Leonard\leonaka01,SF,27,TOR,45,45,1555,415,847,.490,78,219,.356,337,628,.537,.536,297,344,.863,61,280,341,148,83,20,92,67,1205
287,Meyers Leonard\leoname01,C,26,POR,52,1,753,115,212,.542,47,100,.470,68,112,.607,.653,36,44,.818,41,161,202,63,13,9,37,89,313
288,Jon Leuer\leuerjo01,PF,29,DET,34,1,356,61,100,.610,1,10,.100,60,90,.667,.615,22,29,.759,22,66,88,13,12,4,23,54,145
289,Caris LeVert\leverca01,SF,24,BRK,20,18,561,121,273,.443,26,85,.306,95,188,.505,.491,51,70,.729,16,63,79,79,26,9,42,46,319
290,Damian Lillard\lillada01,PG,28,POR,59,59,2080,502,1124,.447,168,457,.368,334,667,.501,.521,353,388,.910,48,221,269,381,68,28,163,108,1525
291,Jeremy Lin\linje01,PG,30,TOT,55,1,1091,192,421,.456,44,142,.310,148,279,.530,.508,151,179,.844,18,116,134,196,40,8,103,103,579
291,Jeremy Lin\linje01,PG,30,ATL,51,1,1003,180,386,.466,44,132,.333,136,254,.535,.523,142,168,.845,16,103,119,181,38,7,98,96,546
291,Jeremy Lin\linje01,PG,30,TOR,4,0,88,12,35,.343,0,10,.000,12,25,.480,.343,9,11,.818,2,13,15,15,2,1,5,7,33
292,Shaun Livingston\livinsh01,PG,33,GSW,47,0,719,85,173,.491,0,2,.000,85,171,.497,.491,35,43,.814,35,58,93,90,25,23,27,55,205
293,Zach Lofton\loftoza01,SG,26,DET,1,0,4,0,1,.000,0,1,.000,0,0,,.000,0,0,,0,0,0,0,1,0,1,0,0
294,Kevon Looney\looneke01,C,22,GSW,60,23,1213,166,271,.613,1,10,.100,165,261,.632,.614,54,86,.628,153,191,344,104,34,47,40,167,387
295,Brook Lopez\lopezbr01,C,30,MIL,60,60,1681,264,582,.454,143,393,.364,121,189,.640,.576,63,76,.829,21,239,260,65,34,129,59,137,734
296,Robin Lopez\lopezro01,C,30,CHI,53,15,981,180,319,.564,6,21,.286,174,298,.584,.574,54,75,.720,78,89,167,53,9,52,66,96,420
297,Kevin Love\loveke01,PF,30,CLE,9,9,234,46,122,.377,21,56,.375,25,66,.379,.463,47,54,.870,15,84,99,18,2,2,22,25,160
298,Kyle Lowry\lowryky01,PG,32,TOR,50,50,1722,234,568,.412,116,342,.339,118,226,.522,.514,133,159,.836,32,191,223,458,72,26,141,133,717
299,Jordan Loyd\loydjo01,PG,25,TOR,8,0,36,5,11,.455,2,5,.400,3,6,.500,.545,4,5,.800,1,6,7,2,0,0,2,5,16
300,Kalin Lucas\lucaska01,PG,29,DET,1,0,6,0,1,.000,0,1,.000,0,0,,.000,2,2,1.000,0,3,3,1,0,0,0,1,2
301,Timothe Luwawu-Cabarrot\luwawti01,SF-SG,23,TOT,29,2,251,29,90,.322,13,47,.277,16,43,.372,.394,12,17,.706,5,34,39,9,7,2,10,31,83
301,Timothe Luwawu-Cabarrot\luwawti01,SF,23,OKC,21,1,123,13,43,.302,5,22,.227,8,21,.381,.360,4,6,.667,4,14,18,4,4,1,5,14,35
301,Timothe Luwawu-Cabarrot\luwawti01,SG,23,CHI,8,1,128,16,47,.340,8,25,.320,8,22,.364,.426,8,11,.727,1,20,21,5,3,1,5,17,48
302,Tyler Lydon\lydonty01,PF,22,DEN,24,0,90,8,17,.471,4,10,.400,4,7,.571,.588,1,3,.333,6,11,17,5,2,0,4,10,21
303,Trey Lyles\lylestr01,PF,23,DEN,55,1,1024,193,456,.423,46,181,.254,147,275,.535,.474,75,108,.694,41,182,223,77,28,23,61,85,507
304,Shelvin Mack\macksh01,PG,28,TOT,55,3,1228,162,396,.409,46,128,.359,116,268,.433,.467,57,82,.695,18,86,104,183,47,4,63,84,427
304,Shelvin Mack\macksh01,PG,28,MEM,53,3,1204,161,389,.414,46,128,.359,115,261,.441,.473,53,75,.707,18,84,102,182,45,4,62,81,421
304,Shelvin Mack\macksh01,PG,28,CHO,2,0,24,1,7,.143,0,0,,1,7,.143,.143,4,7,.571,0,2,2,1,2,0,1,3,6
305,Daryl Macon\maconda01,SG,23,DAL,4,0,8,2,2,1.000,0,0,,2,2,1.000,1.000,0,0,,0,0,0,0,1,0,1,0,4
306,J.P. Macura\macurjp01,SG,23,CHO,1,0,14,2,8,.250,0,4,.000,2,4,.500,.250,0,0,,0,2,2,2,0,0,0,0,4
307,Ian Mahinmi\mahinia01,C,32,WAS,31,6,445,41,83,.494,1,12,.083,40,71,.563,.500,41,60,.683,39,68,107,24,24,15,20,75,124
308,Thon Maker\makerth01,C-PF,21,TOT,41,0,495,67,158,.424,32,95,.337,35,63,.556,.525,26,43,.605,22,91,113,20,13,21,16,62,192
308,Thon Maker\makerth01,C,21,MIL,35,0,409,59,134,.440,26,78,.333,33,56,.589,.537,20,37,.541,17,79,96,18,10,18,9,55,164
308,Thon Maker\makerth01,PF,21,DET,6,0,86,8,24,.333,6,17,.353,2,7,.286,.458,6,6,1.000,5,12,17,2,3,3,7,7,28
309,Boban Marjanovic\marjabo01,C,30,TOT,43,11,495,112,178,.629,0,3,.000,112,175,.640,.629,81,109,.743,67,129,196,32,13,23,48,70,305
309,Boban Marjanovic\marjabo01,C,30,LAC,36,9,376,85,140,.607,0,2,.000,85,138,.616,.607,72,95,.758,55,97,152,22,11,17,37,57,242
309,Boban Marjanovic\marjabo01,C,30,PHI,7,2,119,27,38,.711,0,1,.000,27,37,.730,.711,9,14,.643,12,32,44,10,2,6,11,13,63
310,Lauri Markkanen\markkla01,PF,21,CHI,38,37,1241,261,589,.443,97,253,.383,164,336,.488,.525,114,130,.877,50,294,344,52,30,25,58,89,733
311,Jarell Martin\martija01,PF,24,ORL,32,1,254,35,81,.432,15,39,.385,20,42,.476,.525,7,8,.875,7,45,52,14,2,7,11,35,92
312,Frank Mason\masonfr01,PG,24,SAC,34,0,395,59,142,.415,11,50,.220,48,92,.522,.454,36,53,.679,4,34,38,82,16,4,30,29,165
313,Wesley Matthews\matthwe02,SF-SG,32,TOT,51,50,1521,218,536,.407,117,307,.381,101,229,.441,.516,104,129,.806,22,95,117,115,38,14,65,119,657
313,Wesley Matthews\matthwe02,SF,32,DAL,44,44,1312,194,469,.414,100,263,.380,94,206,.456,.520,87,110,.791,20,82,102,100,33,12,58,102,575
313,Wesley Matthews\matthwe02,SG,32,NYK,2,1,54,4,19,.211,2,10,.200,2,9,.222,.263,4,5,.800,1,2,3,5,1,1,2,2,14
313,Wesley Matthews\matthwe02,SG,32,IND,5,5,155,20,48,.417,15,34,.441,5,14,.357,.573,13,14,.929,1,11,12,10,4,1,5,15,68
314,Luc Mbah a Moute\mbahalu01,PF,32,LAC,4,0,61,8,18,.444,2,6,.333,6,12,.500,.500,2,5,.400,2,5,7,2,1,1,2,8,20
315,Patrick McCaw\mccawpa01,SG,23,TOT,16,0,204,14,41,.341,3,17,.176,11,24,.458,.378,9,9,1.000,6,25,31,14,12,1,10,23,40
315,Patrick McCaw\mccawpa01,SG,23,CLE,3,0,53,2,9,.222,1,4,.250,1,5,.200,.278,0,0,,0,3,3,2,2,0,3,1,5
315,Patrick McCaw\mccawpa01,SG,23,TOR,13,0,151,12,32,.375,2,13,.154,10,19,.526,.406,9,9,1.000,6,22,28,12,10,1,7,22,35
316,CJ McCollum\mccolcj01,SG,27,POR,59,59,2003,487,1060,.459,136,370,.368,351,690,.509,.524,137,165,.830,54,188,242,165,49,22,93,145,1247
317,T.J. McConnell\mccontj01,PG,26,PHI,55,1,1120,165,301,.548,12,34,.353,153,267,.573,.568,20,26,.769,22,104,126,212,69,14,69,88,362
318,Doug McDermott\mcderdo01,SF,27,IND,56,0,964,132,284,.465,65,161,.404,67,123,.545,.579,52,61,.852,11,65,76,50,13,6,28,74,381
319,JaVale McGee\mcgeeja01,C,31,LAL,53,43,1139,256,426,.601,1,8,.125,255,418,.610,.602,71,109,.651,126,233,359,38,32,103,75,136,584
320,Rodney McGruder\mcgruro01,SG,27,MIA,53,45,1329,162,405,.400,67,193,.347,95,212,.448,.483,40,53,.755,45,154,199,102,30,8,59,104,431
321,Alfonzo McKinnie\mckinal01,SF,26,GSW,50,1,701,98,202,.485,29,84,.345,69,118,.585,.557,16,31,.516,63,112,175,19,10,11,23,94,241
322,Ben McLemore\mclembe01,SG,25,SAC,19,0,158,25,64,.391,17,41,.415,8,23,.348,.523,8,12,.667,3,14,17,4,6,3,5,22,75
323,Jordan McRae\mcraejo01,SG,27,WAS,19,0,172,33,66,.500,8,15,.533,25,51,.490,.561,7,12,.583,4,17,21,11,6,5,9,12,81
324,Jodie Meeks\meeksjo01,SG,31,TOR,2,0,24,6,13,.462,3,8,.375,3,5,.600,.577,0,0,,0,4,4,1,0,0,0,2,15
325,Salah Mejri\mejrisa01,C,32,DAL,20,4,170,17,36,.472,1,5,.200,16,31,.516,.486,9,12,.750,16,37,53,11,4,7,6,23,44
326,De'Anthony Melton\meltode01,PG,20,PHO,35,25,694,73,197,.371,24,78,.308,49,119,.412,.431,15,18,.833,17,72,89,114,51,17,55,87,185
327,Chimezie Metu\metuch01,PF,21,SAS,28,0,140,17,54,.315,0,2,.000,17,52,.327,.315,13,17,.765,9,25,34,13,6,2,15,13,47
328,Khris Middleton\middlkh01,SF,27,MIL,57,57,1770,350,803,.436,132,344,.384,218,459,.475,.518,156,185,.843,29,310,339,237,59,5,128,127,988
329,C.J. Miles\milescj01,SF,31,TOT,45,1,674,86,250,.344,50,162,.309,36,88,.409,.444,38,47,.809,12,65,77,28,21,11,25,69,260
329,C.J. Miles\milescj01,SF,31,TOR,40,1,562,70,206,.340,43,137,.314,27,69,.391,.444,35,44,.795,12,56,68,22,18,10,21,62,218
329,C.J. Miles\milescj01,SF,31,MEM,5,0,112,16,44,.364,7,25,.280,9,19,.474,.443,3,3,1.000,0,9,9,6,3,1,4,7,42
330,Darius Miller\milleda01,SF,28,NOP,54,15,1373,144,370,.389,106,284,.373,38,86,.442,.532,36,43,.837,9,88,97,99,34,21,41,132,430
331,Malcolm Miller\millema01,F,25,TOR,1,0,5,1,3,.333,1,2,.500,0,1,.000,.500,0,0,,0,1,1,0,0,0,0,0,3
332,Patty Mills\millspa02,PG,30,SAS,62,1,1484,215,502,.428,117,293,.399,98,209,.469,.545,74,86,.860,20,127,147,190,42,9,71,98,621
333,Paul Millsap\millspa01,PF,33,DEN,49,44,1272,225,457,.492,35,100,.350,190,357,.532,.531,127,177,.718,109,237,346,92,65,43,66,121,612
334,Shake Milton\miltosh01,SG,22,PHI,13,0,126,20,46,.435,10,25,.400,10,21,.476,.543,4,5,.800,7,13,20,13,4,3,3,14,54
335,Nikola Mirotic\mirotni01,PF,27,TOT,35,22,980,197,436,.452,93,252,.369,104,184,.565,.558,85,101,.842,49,228,277,38,22,27,37,90,572
335,Nikola Mirotic\mirotni01,PF,27,NOP,32,22,925,182,407,.447,85,231,.368,97,176,.551,.552,85,101,.842,46,218,264,35,21,25,37,86,534
335,Nikola Mirotic\mirotni01,PF,27,MIL,3,0,55,15,29,.517,8,21,.381,7,8,.875,.655,0,0,,3,10,13,3,1,2,0,4,38
336,Donovan Mitchell\mitchdo01,SG,22,UTA,55,55,1844,457,1089,.420,121,371,.326,336,718,.468,.475,217,270,.804,38,181,219,222,81,20,150,149,1252
337,Naz Mitrou-Long\mitrona01,SG,25,UTA,10,0,39,2,8,.250,1,6,.167,1,2,.500,.313,0,0,,0,2,2,4,0,0,3,5,5
338,Malik Monk\monkma01,SG,20,CHO,57,0,1023,195,499,.391,89,271,.328,106,228,.465,.480,82,92,.891,12,87,99,100,28,15,72,78,561
339,Greg Monroe\monrogr01,C,28,TOR,38,2,423,74,161,.460,0,4,.000,74,157,.471,.460,35,61,.574,60,96,156,16,13,8,31,61,183
340,E'Twaun Moore\mooreet01,SF,29,NOP,49,36,1393,246,507,.485,69,165,.418,177,342,.518,.553,39,52,.750,35,85,120,97,37,8,56,105,600
341,Eric Moreland\moreler01,PF,27,PHO,1,0,5,0,0,,0,0,,0,0,,,0,0,,0,3,3,0,0,0,0,1,0
342,Jaylen Morris\morrija01,SG,23,MIL,4,0,29,4,10,.400,1,3,.333,3,7,.429,.450,1,2,.500,0,5,5,4,2,0,1,1,10
343,Marcus Morris\morrima03,PF,29,BOS,56,39,1553,295,627,.470,115,288,.399,180,339,.531,.562,106,124,.855,53,287,340,79,33,17,70,137,811
344,Markieff Morris\morrima02,PF,29,TOT,37,15,934,147,343,.429,51,154,.331,96,189,.508,.503,62,78,.795,42,143,185,63,26,22,48,127,407
344,Markieff Morris\morrima02,PF,29,WAS,34,15,883,143,328,.436,48,144,.333,95,184,.516,.509,57,73,.781,41,133,174,60,25,20,47,117,391
344,Markieff Morris\morrima02,PF,29,OKC,3,0,51,4,15,.267,3,10,.300,1,5,.200,.367,5,5,1.000,1,10,11,3,1,2,1,10,16
345,Monte Morris\morrimo01,PG,23,DEN,60,5,1481,262,531,.493,71,169,.420,191,362,.528,.560,44,56,.786,26,135,161,232,55,3,38,74,639
346,Johnathan Motley\motlejo01,PF,23,LAC,16,0,131,30,61,.492,0,3,.000,30,58,.517,.492,21,33,.636,15,24,39,8,4,2,13,21,81
347,Emmanuel Mudiay\mudiaem01,PG,22,NYK,42,32,1113,241,526,.458,46,145,.317,195,381,.512,.502,99,132,.750,28,106,134,157,34,14,92,76,627
348,Jamal Murray\murraja01,PG,21,DEN,54,53,1798,370,859,.431,108,292,.370,262,567,.462,.494,131,156,.840,50,180,230,269,45,20,127,116,979
349,Dzanan Musa\musadz01,SG,19,BRK,8,0,34,8,20,.400,0,9,.000,8,11,.727,.400,0,2,.000,1,3,4,1,2,0,4,1,16
350,Mike Muscala\muscami01,PF,27,TOT,49,6,1065,113,289,.391,71,208,.341,42,81,.519,.514,63,77,.818,51,151,202,64,18,29,43,113,360
350,Mike Muscala\muscami01,PF,27,PHI,47,6,1041,109,278,.392,68,199,.342,41,79,.519,.514,63,77,.818,51,149,200,62,18,27,43,112,349
350,Mike Muscala\muscami01,PF,27,LAL,2,0,24,4,11,.364,3,9,.333,1,2,.500,.500,0,0,,0,2,2,2,0,2,0,1,11
351,Sviatoslav Mykhailiuk\mykhasv01,SF-SG,21,TOT,40,0,429,45,136,.331,28,87,.322,17,49,.347,.434,12,20,.600,8,27,35,35,13,1,21,25,130
351,Sviatoslav Mykhailiuk\mykhasv01,SF,21,LAL,39,0,420,44,132,.333,27,85,.318,17,47,.362,.436,12,20,.600,8,26,34,33,13,1,20,25,127
351,Sviatoslav Mykhailiuk\mykhasv01,SG,21,DET,1,0,9,1,4,.250,1,2,.500,0,2,.000,.375,0,0,,0,1,1,2,0,0,1,0,3
352,Abdel Nader\naderab01,SF,25,OKC,41,1,412,61,131,.466,18,51,.353,43,80,.538,.534,14,20,.700,8,61,69,10,10,4,15,46,154
353,Larry Nance\nancela02,C,26,CLE,51,20,1337,183,356,.514,21,60,.350,162,296,.547,.544,76,109,.697,131,286,417,156,71,33,67,148,463
354,Shabazz Napier\napiesh01,PG,27,BRK,50,2,901,153,399,.383,69,206,.335,84,193,.435,.470,108,131,.824,14,76,90,136,40,16,62,61,483
355,Raul Neto\netora01,PG,26,UTA,24,1,283,43,88,.489,10,33,.303,33,55,.600,.545,17,20,.850,2,33,35,55,9,1,21,29,113
356,Georges Niang\niangge01,PF,25,UTA,42,0,312,46,104,.442,29,71,.408,17,33,.515,.582,10,13,.769,7,47,54,21,7,3,13,37,131
357,Joakim Noah\noahjo01,C,33,MEM,32,0,492,75,146,.514,0,0,,75,146,.514,.514,55,78,.705,48,117,165,56,15,22,33,64,205
358,Nerlens Noel\noelne01,C,24,OKC,56,2,813,124,217,.571,0,0,,124,217,.571,.571,38,53,.717,100,164,264,34,57,74,35,128,286
359,Dirk Nowitzki\nowitdi01,PF,40,DAL,29,2,355,54,155,.348,30,100,.300,24,55,.436,.445,15,18,.833,0,57,57,12,5,9,8,41,153
360,Frank Ntilikina\ntilila01,PG,20,NYK,41,16,872,94,275,.342,32,110,.291,62,165,.376,.400,21,28,.750,10,72,82,116,30,14,54,100,241
361,James Nunnally\nunnaja01,SF,28,TOT,15,0,102,12,34,.353,8,25,.320,4,9,.444,.471,4,4,1.000,0,5,5,7,1,0,1,10,36
361,James Nunnally\nunnaja01,SF,28,MIN,13,0,64,9,21,.429,5,13,.385,4,8,.500,.548,4,4,1.000,0,4,4,5,1,0,1,4,27
361,James Nunnally\nunnaja01,SF,28,HOU,2,0,38,3,13,.231,3,12,.250,0,1,.000,.346,0,0,,0,1,1,2,0,0,0,6,9
362,Jusuf Nurkic\nurkiju01,C,24,POR,59,59,1610,341,669,.510,3,26,.115,338,643,.526,.512,222,293,.758,198,403,601,187,58,88,134,203,907
363,David Nwaba\nwabada01,SG,26,CLE,30,11,545,68,148,.459,14,46,.304,54,102,.529,.507,41,64,.641,25,69,94,30,19,9,15,57,191
364,Royce O'Neale\onealro01,SF,25,UTA,59,9,1104,114,234,.487,47,110,.427,67,124,.540,.588,27,36,.750,19,178,197,81,39,18,49,113,302
365,Kyle O'Quinn\oquinky01,C,28,IND,34,2,265,43,93,.462,1,11,.091,42,82,.512,.468,11,12,.917,22,65,87,40,6,18,24,46,98
366,Semi Ojeleye\ojelese01,PF,24,BOS,42,2,454,52,121,.430,22,71,.310,30,50,.600,.521,16,24,.667,18,49,67,18,8,4,13,33,142
367,Jahlil Okafor\okafoja01,C,23,NOP,41,14,617,140,236,.593,0,1,.000,140,235,.596,.593,44,62,.710,65,128,193,25,11,26,31,69,324
368,Elie Okobo\okoboel01,PG,21,PHO,42,11,778,90,238,.378,29,106,.274,61,132,.462,.439,29,35,.829,8,73,81,108,25,5,56,94,238
369,Josh Okogie\okogijo01,SG,20,MIN,52,30,1173,135,365,.370,41,155,.265,94,210,.448,.426,83,112,.741,31,125,156,59,55,19,53,119,394
370,Victor Oladipo\oladivi01,SG,26,IND,36,36,1147,249,588,.423,74,216,.343,175,372,.470,.486,103,141,.730,21,181,202,186,60,11,82,72,675
371,Kelly Olynyk\olynyke01,PF,27,MIA,56,13,1170,176,382,.461,79,229,.345,97,153,.634,.564,99,125,.792,53,198,251,99,34,21,84,127,530
372,Cedi Osman\osmande01,SF,23,CLE,55,54,1732,260,599,.434,91,264,.345,169,335,.504,.510,102,134,.761,31,226,257,128,40,9,88,142,713
373,Kelly Oubre\oubreke01,SF,23,TOT,60,10,1642,304,696,.437,93,293,.317,211,403,.524,.504,157,202,.777,56,216,272,68,65,50,81,157,858
373,Kelly Oubre\oubreke01,SF,23,WAS,29,7,755,132,305,.433,41,132,.311,91,173,.526,.500,68,85,.800,24,105,129,20,27,20,30,71,373
373,Kelly Oubre\oubreke01,SF,23,PHO,31,3,887,172,391,.440,52,161,.323,120,230,.522,.506,89,117,.761,32,111,143,48,38,30,51,86,485
374,Zaza Pachulia\pachuza01,C,34,DET,49,3,697,68,150,.453,0,4,.000,68,146,.466,.453,79,102,.775,86,132,218,69,29,15,42,115,215
375,Jabari Parker\parkeja01,PF,23,TOT,45,17,1207,246,519,.474,41,133,.308,205,386,.531,.513,88,122,.721,44,234,278,105,30,19,102,102,621
375,Jabari Parker\parkeja01,PF,23,CHI,39,17,1042,220,464,.474,37,114,.325,183,350,.523,.514,79,108,.731,41,200,241,84,23,14,84,87,556
375,Jabari Parker\parkeja01,PF,23,WAS,6,0,165,26,55,.473,4,19,.211,22,36,.611,.509,9,14,.643,3,34,37,21,7,5,18,15,65
376,Tony Parker\parketo01,PG,36,CHO,49,0,893,188,411,.457,9,40,.225,179,371,.482,.468,85,117,.726,13,62,75,187,18,6,63,50,470
377,Chandler Parsons\parsoch01,SF,30,MEM,6,3,102,11,41,.268,5,25,.200,6,16,.375,.329,2,2,1.000,1,14,15,5,4,1,5,11,29
378,Patrick Patterson\pattepa01,PF,29,OKC,57,5,839,82,217,.378,46,136,.338,36,81,.444,.484,19,30,.633,41,101,142,31,16,13,21,43,229
379,Chris Paul\paulch01,PG,33,HOU,37,37,1211,197,463,.425,81,224,.362,116,239,.485,.513,122,144,.847,21,141,162,306,75,10,101,99,597
380,Cameron Payne\payneca01,PG,24,TOT,40,13,712,96,223,.430,25,84,.298,71,139,.511,.487,33,41,.805,13,59,72,106,28,9,45,64,250
380,Cameron Payne\payneca01,PG,24,CHI,31,12,536,69,168,.411,16,59,.271,53,109,.486,.458,22,25,.880,10,43,53,83,20,6,34,49,176
380,Cameron Payne\payneca01,PG,24,CLE,9,1,176,27,55,.491,9,25,.360,18,30,.600,.573,11,16,.688,3,16,19,23,8,3,11,15,74
381,Elfrid Payton\paytoel01,PG,24,NOP,22,22,606,92,204,.451,16,46,.348,76,158,.481,.490,25,35,.714,16,65,81,138,25,8,54,48,225
382,Gary Payton\paytoga02,PG,26,WAS,3,0,16,5,8,.625,1,2,.500,4,6,.667,.688,0,0,,1,1,2,4,3,1,1,2,11
383,Theo Pinson\pinsoth01,SG,23,BRK,11,0,161,18,52,.346,8,30,.267,10,22,.455,.423,15,16,.938,2,27,29,17,4,0,14,11,59
384,Mason Plumlee\plumlma01,C,28,DEN,60,16,1234,200,326,.613,2,7,.286,198,319,.621,.617,85,157,.541,128,239,367,160,52,53,96,193,487
385,Miles Plumlee\plumlmi01,C,30,ATL,18,0,173,32,48,.667,0,0,,32,48,.667,.667,16,30,.533,16,23,39,17,6,4,10,14,80
386,Jakob Poeltl\poeltja01,C,23,SAS,58,8,862,133,210,.633,0,0,,133,210,.633,.633,38,69,.551,126,158,284,71,15,39,42,90,304
387,Quincy Pondexter\pondequ01,SF,30,SAS,45,0,260,26,53,.491,6,18,.333,20,35,.571,.547,30,38,.789,8,35,43,23,9,1,10,22,88
388,Otto Porter\porteot01,SF,25,TOT,47,34,1382,244,519,.470,79,203,.389,165,316,.522,.546,58,75,.773,49,213,262,96,68,25,50,93,625
388,Otto Porter\porteot01,SF,25,WAS,41,28,1191,202,442,.457,65,176,.369,137,266,.515,.531,49,64,.766,40,191,231,80,64,22,40,79,518
388,Otto Porter\porteot01,SF,25,CHI,6,6,191,42,77,.545,14,27,.519,28,50,.560,.636,9,11,.818,9,22,31,16,4,3,10,14,107
389,Bobby Portis\portibo01,PF,23,TOT,28,7,696,161,349,.461,40,98,.408,121,251,.482,.519,43,57,.754,55,151,206,40,19,10,40,82,405
389,Bobby Portis\portibo01,PF,23,CHI,22,6,531,122,271,.450,27,72,.375,95,199,.477,.500,39,50,.780,46,115,161,29,11,8,29,61,310
389,Bobby Portis\portibo01,PF,23,WAS,6,1,165,39,78,.500,13,26,.500,26,52,.500,.583,4,7,.571,9,36,45,11,8,2,11,21,95
390,Dwight Powell\poweldw01,C,27,DAL,56,1,1018,185,319,.580,21,84,.250,164,235,.698,.613,125,163,.767,81,171,252,63,28,33,44,137,516
391,Norman Powell\powelno01,SG,25,TOR,40,3,741,120,258,.465,40,111,.360,80,147,.544,.543,43,53,.811,9,67,76,62,26,8,35,66,323
392,Alex Poythress\poythal01,PF,25,ATL,18,1,243,35,65,.538,7,18,.389,28,47,.596,.592,11,21,.524,24,35,59,13,3,8,10,39,88
393,Zhou Qi\qizh01,PF,23,HOU,1,0,1,1,1,1.000,0,0,,1,1,1.000,1.000,0,0,,0,0,0,0,0,0,0,0,2
394,Ivan Rabb\rabbiv01,PF,21,MEM,32,8,387,72,119,.605,2,7,.286,70,112,.625,.613,27,40,.675,43,76,119,29,8,8,20,49,173
395,Chasson Randle\randlch01,PG,25,WAS,30,2,466,62,136,.456,30,67,.448,32,69,.464,.566,26,40,.650,7,33,40,64,14,1,34,62,180
396,Julius Randle\randlju01,C,24,NOP,55,31,1633,401,751,.534,42,121,.347,359,630,.570,.562,262,355,.738,118,378,496,163,38,35,146,187,1106
397,J.J. Redick\redicjj01,SG,34,PHI,57,44,1784,345,778,.443,175,449,.390,170,329,.517,.556,173,192,.901,16,115,131,158,25,12,80,103,1038
398,Davon Reed\reedda01,SG,23,IND,7,0,20,2,4,.500,1,1,1.000,1,3,.333,.625,0,0,,1,1,2,2,0,0,1,1,5
399,Josh Richardson\richajo01,SG,25,MIA,57,57,1981,345,829,.416,136,369,.369,209,460,.454,.498,165,191,.864,42,161,203,227,60,28,101,162,991
400,Malachi Richardson\richama01,SG,23,TOR,22,0,103,9,29,.310,8,25,.320,1,4,.250,.448,4,5,.800,2,11,13,0,1,0,8,13,30
401,Austin Rivers\riverau01,SG-PG,26,TOT,56,15,1557,178,446,.399,81,256,.316,97,190,.511,.490,43,79,.544,22,110,132,138,37,19,58,158,480
401,Austin Rivers\riverau01,SG,26,WAS,29,2,683,76,194,.392,33,106,.311,43,88,.489,.477,25,46,.543,11,60,71,58,18,10,36,72,210
401,Austin Rivers\riverau01,PG,26,HOU,27,13,874,102,252,.405,48,150,.320,54,102,.529,.500,18,33,.545,11,50,61,80,19,9,22,86,270
402,Devin Robinson\robinde01,SF,23,WAS,4,0,32,8,13,.615,0,0,,8,13,.615,.615,3,6,.500,2,5,7,2,3,1,0,2,19
403,Duncan Robinson\robindu01,PF,24,MIA,8,1,71,6,16,.375,4,14,.286,2,2,1.000,.500,1,2,.500,0,9,9,1,2,0,1,4,17
404,Glenn Robinson\robingl02,SF,25,DET,33,17,440,46,120,.383,13,43,.302,33,77,.429,.438,27,33,.818,10,31,41,13,11,5,17,30,132
405,Jerome Robinson\robinje01,SG,21,LAC,24,0,223,30,79,.380,14,41,.341,16,38,.421,.468,4,6,.667,3,24,27,8,7,2,4,35,78
406,Mitchell Robinson\robinmi01,C,20,NYK,45,12,826,123,179,.687,0,0,,123,179,.687,.687,44,79,.557,114,113,227,25,34,103,21,137,290
407,Rajon Rondo\rondora01,PG,32,LAL,26,9,707,91,209,.435,23,56,.411,68,153,.444,.490,11,20,.550,19,107,126,185,22,4,70,61,216
408,Derrick Rose\rosede01,PG,30,MIN,44,13,1240,316,658,.480,54,139,.388,262,519,.505,.521,125,146,.856,28,94,122,203,29,11,77,48,811
409,Terrence Ross\rosste01,SG,27,ORL,62,0,1625,336,781,.430,152,400,.380,184,381,.483,.528,86,99,.869,23,190,213,93,52,23,63,94,910
410,Terry Rozier\roziete01,PG,24,BOS,60,10,1383,191,507,.377,90,255,.353,101,252,.401,.465,62,75,.827,26,220,246,187,55,18,52,76,534
411,Ricky Rubio\rubiori01,PG,28,UTA,52,51,1515,241,584,.413,71,217,.327,170,367,.463,.473,136,161,.845,24,169,193,315,68,9,153,143,689
412,D'Angelo Russell\russeda01,PG,22,BRK,61,61,1845,481,1107,.435,172,462,.372,309,645,.479,.512,118,143,.825,35,196,231,408,68,18,180,105,1252
413,Domantas Sabonis\sabondo01,C,22,IND,59,5,1467,333,546,.610,8,14,.571,325,532,.611,.617,167,229,.729,150,398,548,162,42,26,126,190,841
414,Brandon Sampson\sampsbr01,SG,21,CHI,4,0,28,5,7,.714,2,4,.500,3,3,1.000,.857,0,0,,0,4,4,1,0,0,0,3,12
415,Dario Saric\saricda01,PF,24,TOT,59,19,1466,211,490,.431,86,232,.371,125,258,.484,.518,89,102,.873,90,247,337,89,33,7,69,133,597
415,Dario Saric\saricda01,PF,24,PHI,13,13,396,48,132,.364,21,70,.300,27,62,.435,.443,27,30,.900,21,65,86,26,4,3,25,39,144
415,Dario Saric\saricda01,PF,24,MIN,46,6,1070,163,358,.455,65,162,.401,98,196,.500,.546,62,72,.861,69,182,251,63,29,4,44,94,453
416,Tomas Satoransky\satorto01,SG,27,WAS,58,32,1432,175,352,.497,47,107,.439,128,245,.522,.564,76,96,.792,51,131,182,249,61,10,76,122,473
417,Dennis Schroder\schrode01,PG,25,OKC,57,10,1617,333,797,.418,85,247,.344,248,550,.451,.471,133,162,.821,26,165,191,236,52,9,129,129,884
418,Mike Scott\scottmi01,PF,30,TOT,59,0,896,109,272,.401,63,157,.401,46,115,.400,.517,14,23,.609,28,158,186,52,19,9,33,101,295
418,Mike Scott\scottmi01,PF,30,LAC,52,0,748,92,230,.400,52,133,.391,40,97,.412,.513,12,18,.667,24,150,174,44,17,8,27,88,248
418,Mike Scott\scottmi01,PF,30,PHI,7,0,148,17,42,.405,11,24,.458,6,18,.333,.536,2,5,.400,4,8,12,8,2,1,6,13,47
419,Thabo Sefolosha\sefolth01,SF,34,UTA,29,0,306,31,62,.500,14,30,.467,17,32,.531,.613,8,14,.571,6,70,76,12,23,2,16,24,84
420,Wayne Selden\seldewa01,SG,24,TOT,54,5,944,125,302,.414,41,116,.353,84,186,.452,.482,45,58,.776,24,70,94,72,18,8,51,89,336
420,Wayne Selden\seldewa01,SG,24,MEM,32,0,455,65,161,.404,20,63,.317,45,98,.459,.466,22,29,.759,16,28,44,36,10,6,23,48,172
420,Wayne Selden\seldewa01,SG,24,CHI,22,5,489,60,141,.426,21,53,.396,39,88,.443,.500,23,29,.793,8,42,50,36,8,2,28,41,164
421,Collin Sexton\sextoco01,PG,20,CLE,61,51,1860,348,860,.405,69,175,.394,279,685,.407,.445,147,173,.850,45,143,188,175,35,3,135,145,912
422,Landry Shamet\shamela01,SG-PG,21,TOT,60,8,1274,172,395,.435,113,278,.406,59,117,.504,.578,54,65,.831,16,69,85,70,32,8,33,115,511
422,Landry Shamet\shamela01,SG,21,PHI,54,4,1108,153,347,.441,99,245,.404,54,102,.529,.584,44,54,.815,14,64,78,59,24,8,26,106,449
422,Landry Shamet\shamela01,PG,21,LAC,6,4,166,19,48,.396,14,33,.424,5,15,.333,.542,10,11,.909,2,5,7,11,8,0,7,9,62
423,Iman Shumpert\shumpim01,SG,28,TOT,46,40,1182,139,370,.376,79,222,.356,60,148,.405,.482,34,41,.829,21,116,137,98,50,21,40,101,391
423,Iman Shumpert\shumpim01,SG,28,SAC,42,40,1099,133,348,.382,74,202,.366,59,146,.404,.489,34,41,.829,19,110,129,91,47,20,38,92,374
423,Iman Shumpert\shumpim01,SG,28,HOU,4,0,83,6,22,.273,5,20,.250,1,2,.500,.386,0,0,,2,6,8,7,3,1,2,9,17
424,Pascal Siakam\siakapa01,PF,24,TOR,61,60,1928,380,689,.552,55,149,.369,325,540,.602,.591,178,226,.788,97,332,429,175,60,42,107,182,993
425,Ben Simmons\simmobe01,PG,22,PHI,60,60,2036,411,725,.567,0,4,.000,411,721,.570,.567,197,334,.590,131,408,539,466,77,44,213,146,1019
426,Jonathon Simmons\simmojo02,SG-SF,29,TOT,47,9,925,113,309,.366,22,91,.242,91,218,.417,.401,63,83,.759,25,83,108,103,23,14,61,80,311
426,Jonathon Simmons\simmojo02,SG,29,ORL,41,9,845,104,286,.364,19,83,.229,85,203,.419,.397,56,72,.778,23,77,100,95,18,14,56,68,283
426,Jonathon Simmons\simmojo02,SF,29,PHI,6,0,80,9,23,.391,3,8,.375,6,15,.400,.457,7,11,.636,2,6,8,8,5,0,5,12,28
427,Kobi Simmons\simmoko01,PG,21,CLE,1,0,2,0,0,,0,0,,0,0,,,0,0,,0,0,0,0,0,0,0,0,0
428,Anfernee Simons\simonan01,SG,19,POR,12,0,60,7,25,.280,0,9,.000,7,16,.438,.280,1,4,.250,0,7,7,4,0,0,7,3,15
429,Marcus Smart\smartma01,SG,24,BOS,60,40,1624,162,407,.398,92,259,.355,70,148,.473,.511,75,97,.773,43,134,177,242,101,24,89,149,491
430,Dennis Smith\smithde03,PG,21,TOT,42,42,1199,215,493,.436,52,157,.331,163,336,.485,.489,86,134,.642,24,101,125,203,57,16,123,109,568
430,Dennis Smith\smithde03,PG,21,DAL,32,32,908,157,357,.440,43,125,.344,114,232,.491,.500,57,82,.695,18,79,97,138,40,11,100,82,414
430,Dennis Smith\smithde03,PG,21,NYK,10,10,291,58,136,.426,9,32,.281,49,104,.471,.460,29,52,.558,6,22,28,65,17,5,23,27,154
431,Ish Smith\smithis01,PG,30,DET,33,0,732,111,274,.405,34,96,.354,77,178,.433,.467,24,31,.774,7,61,68,105,15,8,39,64,280
432,J.R. Smith\smithjr01,SG,33,CLE,11,4,222,27,79,.342,12,39,.308,15,40,.375,.418,8,10,.800,0,18,18,21,11,3,11,19,74
433,Jason Smith\smithja02,C-PF,32,TOT,18,1,170,19,50,.380,7,19,.368,12,31,.387,.450,12,14,.857,14,34,48,13,3,7,12,27,57
433,Jason Smith\smithja02,C,32,WAS,12,1,130,15,37,.405,4,10,.400,11,27,.407,.459,10,12,.833,11,26,37,12,1,5,7,21,44
433,Jason Smith\smithja02,PF,32,MIL,6,0,40,4,13,.308,3,9,.333,1,4,.250,.423,2,2,1.000,3,8,11,1,2,2,5,6,13
434,Tony Snell\snellto01,SG,27,MIL,60,8,1032,131,289,.453,66,166,.398,65,123,.528,.567,33,37,.892,22,97,119,54,22,14,19,68,361
435,Ray Spalding\spaldra01,PF,21,DAL,1,0,1,0,0,,0,0,,0,0,,,0,0,,0,0,0,0,0,0,0,0,0
436,Omari Spellman\spellom01,PF,21,ATL,44,10,766,92,232,.397,43,124,.347,49,108,.454,.489,30,43,.698,66,116,182,42,26,24,28,65,257
437,Nik Stauskas\stausni01,SG,25,TOT,48,0,726,100,246,.407,46,136,.338,54,110,.491,.500,34,38,.895,11,75,86,63,15,5,42,36,280
437,Nik Stauskas\stausni01,SG,25,POR,44,0,673,96,229,.419,43,125,.344,53,104,.510,.513,32,36,.889,10,70,80,62,14,4,40,31,267
437,Nik Stauskas\stausni01,SG,25,CLE,4,0,53,4,17,.235,3,11,.273,1,6,.167,.324,2,2,1.000,1,5,6,1,1,1,2,5,13
438,D.J. Stephens\stephdj01,SG,28,MEM,1,0,7,1,2,.500,0,0,,1,2,.500,.500,0,0,,0,0,0,0,1,0,1,0,2
439,Lance Stephenson\stephla01,SG,28,LAL,59,0,922,161,366,.440,62,164,.378,99,202,.490,.525,42,63,.667,26,145,171,117,35,5,75,95,426
440,Edmond Sumner\sumneed01,PG,23,IND,17,2,167,16,49,.327,4,20,.200,12,29,.414,.367,5,12,.417,7,12,19,7,9,5,8,21,41
441,Caleb Swanigan\swanica01,PF,21,POR,18,0,145,14,44,.318,1,5,.200,13,39,.333,.330,6,7,.857,13,39,52,7,4,0,16,22,35
442,Jayson Tatum\tatumja01,SF,20,BOS,61,61,1898,369,809,.456,95,249,.382,274,560,.489,.515,163,189,.862,60,323,383,113,63,50,90,133,996
443,Jeff Teague\teaguje01,PG,30,MIN,36,35,1078,148,349,.424,30,87,.345,118,262,.450,.467,103,128,.805,12,75,87,292,38,14,82,75,429
444,Garrett Temple\templga01,SG,32,TOT,55,51,1647,177,413,.429,77,224,.344,100,189,.529,.522,62,83,.747,20,145,165,75,53,27,56,152,493
444,Garrett Temple\templga01,SG,32,MEM,49,49,1530,166,387,.429,74,210,.352,92,177,.520,.525,57,76,.750,18,134,152,69,50,25,54,134,463
444,Garrett Temple\templga01,SG,32,LAC,6,2,117,11,26,.423,3,14,.214,8,12,.667,.481,5,7,.714,2,11,13,6,3,2,2,18,30
445,Milos Teodosic\teodomi01,PG,31,LAC,15,0,150,17,40,.425,10,27,.370,7,13,.538,.550,4,7,.571,3,13,16,32,3,1,21,27,48
446,Jared Terrell\terreja01,SG,23,MIN,7,0,67,8,26,.308,4,11,.364,4,15,.267,.385,1,2,.500,1,2,3,7,3,1,7,8,21
447,Emanuel Terry\terryem01,PF,22,TOT,3,0,23,4,7,.571,0,0,,4,7,.571,.571,2,4,.500,3,4,7,2,3,0,2,4,10
447,Emanuel Terry\terryem01,PF,22,PHO,2,0,20,4,6,.667,0,0,,4,6,.667,.667,1,2,.500,2,4,6,1,3,0,2,4,9
447,Emanuel Terry\terryem01,PF,22,MIA,1,0,3,0,1,.000,0,0,,0,1,.000,.000,1,2,.500,1,0,1,1,0,0,0,0,1
448,Daniel Theis\theisda01,C,26,BOS,47,2,701,118,204,.578,23,51,.451,95,153,.621,.635,48,64,.750,65,115,180,53,15,31,26,120,307
449,Isaiah Thomas\thomais02,PG,29,DEN,4,0,68,14,33,.424,8,20,.400,6,13,.462,.545,9,14,.643,2,3,5,9,0,1,10,9,45
450,Khyri Thomas\thomakh01,SG,22,DET,18,0,158,17,48,.354,10,29,.345,7,19,.368,.458,6,9,.667,3,12,15,5,5,4,3,16,50
451,Lance Thomas\thomala01,PF,30,NYK,28,13,473,44,109,.404,10,42,.238,34,67,.507,.450,20,25,.800,16,56,72,14,16,6,14,60,118
452,Klay Thompson\thompkl01,SG,28,GSW,59,59,2022,502,1071,.469,175,440,.398,327,631,.518,.550,109,134,.813,28,206,234,138,66,38,90,126,1288
453,Tristan Thompson\thomptr01,C,27,CLE,35,35,1043,173,329,.526,0,0,,173,329,.526,.526,55,85,.647,154,235,389,75,28,16,50,81,401
454,Sindarius Thornwell\thornsi01,SG,24,LAC,44,1,251,15,43,.349,2,13,.154,13,30,.433,.372,16,23,.696,4,32,36,14,11,3,18,36,48
455,Anthony Tolliver\tollian01,PF,33,MIN,43,0,653,62,147,.422,50,125,.400,12,22,.545,.592,25,34,.735,11,87,98,21,13,14,22,59,199
456,Karl-Anthony Towns\townska01,C,23,MIN,58,58,1919,492,953,.516,103,263,.392,389,690,.564,.570,266,315,.844,194,513,707,189,53,103,169,216,1353
457,Gary Trent\trentga02,SG,20,POR,9,0,38,5,19,.263,3,9,.333,2,10,.200,.342,1,4,.250,0,4,4,1,0,1,1,1,14
458,Allonzo Trier\trieral01,SG,23,NYK,54,3,1203,185,409,.452,37,97,.381,148,312,.474,.498,147,174,.845,25,138,163,103,25,14,97,93,554
459,P.J. Tucker\tuckepj01,PF,33,HOU,60,60,2116,160,408,.392,105,290,.362,55,118,.466,.521,37,55,.673,93,282,375,75,101,28,49,189,462
460,Evan Turner\turneev01,PG,30,POR,57,2,1329,177,385,.460,7,46,.152,170,339,.501,.469,60,85,.706,33,227,260,222,28,14,94,92,421
461,Myles Turner\turnemy01,C,22,IND,54,54,1525,289,572,.505,51,126,.405,238,446,.534,.550,93,129,.721,70,305,375,87,40,148,75,140,722
462,Ekpe Udoh\udohek01,C,31,UTA,35,0,192,28,39,.718,0,0,,28,39,.718,.718,10,16,.625,12,28,40,14,4,17,8,23,66
463,Tyler Ulis\ulisty01,PG,23,CHI,1,0,1,0,0,,0,0,,0,0,,,0,0,,0,0,0,0,0,0,0,0,0
464,Jonas Valanciunas\valanjo01,C,26,TOT,34,12,662,183,318,.575,10,34,.294,173,284,.609,.591,88,110,.800,67,190,257,37,14,28,50,96,464
464,Jonas Valanciunas\valanjo01,C,26,TOR,30,10,564,149,259,.575,9,30,.300,140,229,.611,.593,77,94,.819,54,162,216,29,13,23,39,82,384
464,Jonas Valanciunas\valanjo01,C,26,MEM,4,2,98,34,59,.576,1,4,.250,33,55,.600,.585,11,16,.688,13,28,41,8,1,5,11,14,80
465,Jarred Vanderbilt\vandeja01,PF,19,DEN,6,0,18,1,5,.200,0,0,,1,5,.200,.200,1,4,.250,3,9,12,1,2,1,2,0,3
466,Fred VanVleet\vanvlfr01,PG,24,TOR,51,22,1369,189,469,.403,85,232,.366,104,237,.439,.494,75,90,.833,20,118,138,234,45,12,65,90,538
467,Noah Vonleh\vonleno01,PF,23,NYK,61,50,1538,177,391,.453,44,131,.336,133,260,.512,.509,96,133,.722,102,376,478,115,44,48,75,155,494
468,Nikola Vucevic\vucevni01,C,28,ORL,61,61,1896,534,1017,.525,70,178,.393,464,839,.553,.559,121,158,.766,166,569,735,239,59,72,119,117,1259
469,Dwyane Wade\wadedw01,SG,37,MIA,49,0,1256,263,610,.431,54,173,.312,209,437,.478,.475,110,161,.683,44,139,183,212,35,26,112,78,690
470,Moritz Wagner\wagnemo01,C,21,LAL,23,0,154,28,65,.431,12,32,.375,16,33,.485,.523,9,15,.600,9,26,35,10,6,3,12,18,77
471,Dion Waiters\waitedi01,SG,27,MIA,21,7,501,87,210,.414,43,124,.347,44,86,.512,.517,8,17,.471,4,46,50,61,13,3,29,25,225
472,Kemba Walker\walkeke02,PG,28,CHO,60,60,2079,521,1217,.428,199,555,.359,322,662,.486,.510,263,317,.830,34,224,258,340,74,27,151,92,1504
473,Lonnie Walker\walkelo01,SG,20,SAS,6,0,57,4,21,.190,2,6,.333,2,15,.133,.238,4,4,1.000,0,10,10,2,3,1,4,3,14
474,John Wall\walljo01,PG,28,WAS,32,32,1104,245,552,.444,51,169,.302,194,383,.507,.490,122,175,.697,15,101,116,279,49,29,121,71,663
475,Tyrone Wallace\wallaty01,PG,24,LAC,47,0,495,75,174,.431,3,15,.200,72,159,.453,.440,24,49,.490,18,60,78,30,18,7,23,66,177
476,Taurean Waller-Prince\princta02,SF,24,ATL,39,31,1084,183,422,.434,85,226,.376,98,196,.500,.534,71,85,.835,18,129,147,75,40,14,77,100,522
477,Brad Wanamaker\wanambr01,PG,29,BOS,27,0,250,34,72,.472,16,31,.516,18,41,.439,.583,14,15,.933,2,25,27,37,9,1,14,19,98
478,T.J. Warren\warretj01,SF,25,PHO,43,36,1360,297,611,.486,77,180,.428,220,431,.510,.549,101,124,.815,31,143,174,64,51,29,52,119,772
479,Julian Washburn\washbju01,SF,27,MEM,7,2,110,3,19,.158,1,8,.125,2,11,.182,.184,3,4,.750,4,16,20,3,4,0,3,5,10
480,Yuta Watanabe\watanyu01,SG,24,MEM,10,0,98,10,28,.357,2,9,.222,8,19,.421,.393,7,10,.700,1,18,19,4,2,1,4,3,29
481,Thomas Welsh\welshth01,C,22,DEN,9,0,33,5,10,.500,3,7,.429,2,3,.667,.650,1,2,.500,0,4,4,4,0,0,1,2,14
482,Russell Westbrook\westbru01,PG,30,OKC,52,52,1858,440,1036,.425,70,259,.270,370,777,.476,.458,219,334,.656,78,510,588,569,111,23,245,183,1169
483,Derrick White\whitede01,PG,24,SAS,47,35,1184,173,353,.490,32,93,.344,141,260,.542,.535,68,89,.764,22,142,164,170,49,24,71,99,446
484,Okaro White\whiteok01,PF,26,WAS,3,0,6,0,2,.000,0,2,.000,0,0,,.000,0,0,,1,1,2,0,0,0,0,0,0
485,Hassan Whiteside\whiteha01,C,29,MIA,53,53,1346,299,539,.555,2,16,.125,297,523,.568,.557,86,199,.432,200,450,650,46,40,110,81,146,686
486,Andrew Wiggins\wiggian01,SF,23,MIN,54,54,1876,352,890,.396,86,256,.336,266,634,.420,.444,166,234,.709,67,196,263,132,57,34,101,109,956
487,Alan Williams\willial03,PF,26,BRK,3,0,17,4,8,.500,0,1,.000,4,7,.571,.500,2,4,.500,3,11,14,2,0,0,1,2,10
488,C.J. Williams\willicj01,SG,28,MIN,9,0,67,7,17,.412,1,7,.143,6,10,.600,.441,0,0,,1,3,4,6,1,0,4,11,15
489,Johnathan Williams\willijo04,C,23,LAL,7,0,89,11,20,.550,0,0,,11,20,.550,.550,1,5,.200,11,10,21,4,1,4,2,20,23
490,Kenrich Williams\willike04,SF,24,NOP,26,9,491,55,133,.414,23,69,.333,32,64,.500,.500,8,13,.615,23,91,114,38,10,10,19,47,141
491,Lou Williams\willilo02,SG,32,LAC,56,0,1472,358,843,.425,79,216,.366,279,627,.445,.472,321,358,.897,24,139,163,302,37,8,135,61,1116
492,Marvin Williams\willima02,PF,32,CHO,59,59,1675,222,519,.428,115,313,.367,107,206,.519,.539,54,72,.750,55,280,335,71,52,45,31,129,613
493,Robert Williams\williro04,C,21,BOS,24,0,220,31,42,.738,0,0,,31,42,.738,.738,8,12,.667,22,37,59,5,6,32,9,28,70
494,Troy Williams\willitr02,SF,24,SAC,18,0,286,40,87,.460,14,41,.341,26,46,.565,.540,9,15,.600,9,46,55,10,10,8,8,34,103
495,D.J. Wilson\wilsodj01,PF,22,MIL,30,0,549,65,148,.439,28,75,.373,37,73,.507,.534,11,28,.393,27,112,139,28,12,18,19,59,169
496,Justise Winslow\winslju01,PF,22,MIA,52,39,1544,247,585,.422,74,199,.372,173,386,.448,.485,73,113,.646,51,234,285,216,53,15,113,137,641
497,Christian Wood\woodch01,PF,23,MIL,12,0,55,11,23,.478,2,4,.500,9,19,.474,.522,10,15,.667,4,15,19,2,0,0,3,3,34
498,Delon Wright\wrighde01,PG,26,TOT,55,3,1065,147,346,.425,34,108,.315,113,238,.475,.474,62,71,.873,43,110,153,131,52,18,42,65,390
498,Delon Wright\wrighde01,PG,26,TOR,49,2,897,127,293,.433,30,90,.333,97,203,.478,.485,53,61,.869,39,86,125,110,46,15,37,53,337
498,Delon Wright\wrighde01,PG,26,MEM,6,1,168,20,53,.377,4,18,.222,16,35,.457,.415,9,10,.900,4,24,28,21,6,3,5,12,53
499,Guerschon Yabusele\yabusgu01,PF,23,BOS,31,0,173,23,53,.434,4,19,.211,19,34,.559,.472,10,14,.714,16,20,36,12,7,7,11,27,60
500,Nick Young\youngni01,SG,33,DEN,4,0,37,3,9,.333,3,8,.375,0,1,.000,.500,0,0,,0,1,1,2,0,1,2,4,9
501,Thaddeus Young\youngth01,PF,30,IND,61,61,1848,338,636,.531,33,93,.355,305,543,.562,.557,65,103,.631,148,245,393,133,99,29,86,148,774
502,Trae Young\youngtr01,PG,20,ATL,61,61,1854,365,891,.410,115,350,.329,250,541,.462,.474,224,277,.809,39,160,199,468,52,13,239,103,1069
503,Cody Zeller\zelleco01,C,26,CHO,43,41,1090,166,295,.563,5,20,.250,161,275,.585,.571,98,122,.803,103,192,295,90,33,38,55,140,435
504,Ante Zizic\zizican01,C,22,CLE,44,15,748,124,231,.537,0,0,,124,231,.537,.537,65,88,.739,73,157,230,30,11,17,40,83,313
505,Ivica Zubac\zubaciv01,C,21,TOT,39,18,635,132,233,.567,0,0,,132,233,.567,.567,70,82,.854,63,139,202,32,6,32,42,90,334
505,Ivica Zubac\zubaciv01,C,21,LAL,33,12,516,112,193,.580,0,0,,112,193,.580,.580,57,66,.864,54,108,162,25,4,27,33,73,281
505,Ivica Zubac\zubaciv01,C,21,LAC,6,6,119,20,40,.500,0,0,,20,40,.500,.500,13,16,.813,9,31,40,7,2,5,9,17,53
